WWWWWWWWWWWW
WEEEWEEEEBEW
WEEEWEEEWEEW
WEEEEEEEWEEW
WEEEWEEEWEEW
WWWWWWWWWWWW

WWWWWWWWWWWW
WEEEWEEEEYEW
WEEEWEEEWEEW
WEEEEEEEWEEW
WEEEWEEEWEEW
WWWWWWWWWWWW