WWWWWWWWWWWWWWWW
WWWEEEWWWEEEEEEW
WWEEWEWWEWEEEWWW
WEWEWWEEEWWEEEEW
WEEEKEWEEEEWEEWW
WEWEEWEEWEEEWEEW
WEWEEEWWEEEEEEEW
WWEEEWWEEEEEWEEW
WEWEEEEWWWEEEEEW
WWEEEWEWEEEEEWEW
WEEWWEWEEEEWEEWW
WEGEEEEEEEEEEEWW
WWWEEWEWWWEEWEEW
WEEEWEEWEEEEWEEW
WWEEWWEWWEEWEEWW
WWWWWWWWWWWWWWWW

WWWWWWWWWWWWWWWW
WWWEEEWWWEEEEEEW
WWEEWEWWEWEEEWWW
WEWEWWEEEWWEEEEW
WEEEYEWEEEEWEEWW
WEWEEWEEWEEEWEEW
WEWEEEWWEEEEEEEW
WWEEEWWEEEEEWEEW
WEWEEEEWWWEEEEEW
WWEEEWEWEEEEEWEW
WEEWWEWEEEEWEEWW
WEGEEEEEEEEEEEWW
WWWEEWEWWWEEWEEW
WEEEWEEWEEEEWEEW
WWEEWWEWWEEWEEWW
WWWWWWWWWWWWWWWW