WWWWWWWWWWWW
WEWEEEEEEEEW
WEWEEEEWWEEW
WEWWWEEEWEGW
WEEEEEEEWEEW
WWWWWWWWWWWW

WWWWWWWWWWWW
WEWEEEEEEEEW
WEWEEEEWWEEW
WEWWWEEEWEGW
WEEEEEEEWEEW
WWWWWWWWWWWW