WWWWWWWWWWWW
WEEEWEEEWEEW
WEEEOEEEWEBW
WEEEWEEEWEEW
WEKEWEEEDEEW
WWWWWWWWWWWW


WWWWWWWWWWWW
WEEEWEEEWEEW
WEEEBEEEWEYW
WEEEWEEEWEEW
WEYEWEEEYEEW
WWWWWWWWWWWW