WWWWWWWWWWW
WEWEEEEEEWW
WEWEEWWWEEW
WEWEEEEWEEW
WEWEEEEWEEW
WEWWWWEWEEW
WEWEEWEWEEW
WEWEEEEWEEW
WEWWEEEWEGW
WEEEEWEWEEW
WWWWWWWWWWW

WWWWWWWWWWW
WEWEEEEEEWW
WEWEEWWWEEW
WEWEEEEWEEW
WEWEEEEWEEW
WEWWWWEWEEW
WEWEEWEWEEW
WEWEEEEWEEW
WEWWEEEWEGW
WEEEEWEWEEW
WWWWWWWWWWW