WWWWWWWWWWWW
WEEEWEEEEEEW
WEEEWEEEWEEW
WEEEEEEEWEGW
WEEEWEEEWEEW
WWWWWWWWWWWW

WWWWWWWWWWWW
WEEEWEEEEEEW
WEEEWEEEWEEW
WEEEEEEEWEGW
WEEEWEEEWEEW
WWWWWWWWWWWW