WWWWWWWWWWWW
WEEEWEKEEDEW
WKEEWDEEWEEW
WKEEEEEEWGEW
WEWEWEKEWEEW
WWWWWWWWWWWW

WWWWWWWWWWWW
WEEEWEYEEYEW
WYEEWYEEWEEW
WYEEEEEEWGEW
WEWEWEYEWEEW
WWWWWWWWWWWW