WWWWWWWW
WEEEWWWW
WWWEEEWW
WWEEEWWW
WGEEEEWW
WWWWWWWW

WWWWWWWW
WEEEWWWW
WWWEEEWW
WWEEEWWW
WGEEEEWW
WWWWWWWW