WWWWWWWWWWW
WEWEEEEEEEW
WEWEEEWWEEW
WEWEEEEWEEW
WEWEEEEWEEW
WEWWWEEWEEW
WEEEEEEWEEW
WEEEEEEWEEW
WEEEEEEWEGW
WEEEEEEWEEW
WWWWWWWWWWW

WWWWWWWWWWW
WEWEEEEEEEW
WEWEEEWWEEW
WEWEEEEWEEW
WEWEEEEWEEW
WEWWWEEWEEW
WEEEEEEWEEW
WEEEEEEWEEW
WEEEEEEWEGW
WEEEEEEWEEW
WWWWWWWWWWW