WWWWWWWWWWWW
WEEEWEEEEEEW
WEEEWEEEWEEW
WEEEEEEEWGEW
WEEEWEEEWEEW
WWWWWWWWWWWW

WWWWWWWWWWWW
WEEEWEEEEEEW
WEEEWEEEWEEW
WEEEEEEEWGEW
WEEEWEEEWEEW
WWWWWWWWWWWW