WWWWWWWWWWWW
WEEKEEEEEKEW
WWwEEDEEWEDW
WEEKEWEEWGEW
WEWEEEWWEEEW
WWWWWWWWWWWW

WWWWWWWWWWWW
WEEYEEEEEYEW
WWwEEYEEWEYW
WEEYEWEEWGEW
WEWEEEWWEEEW
WWWWWWWWWWWW