WWWWWWWWWWWWWWWWWWWWW
WWEWWEWWEEWEEWEEEWEEW
WWWEEEEEEEEEEEEEWWWWW
WWWWEEEWWEEEWEWEEEEEW
WGEEEWEWWEEEEEEEWWKEW
WWEEEWEEWWWEEEWEEEEEW
WWEEEWEWEEEEWEWEEWEEW
WWEEEEWEWEEEEWEEWEWEW
WEWEEDEEEWEEWEEEEEWWW
WEEWWWEWEEWWEWWEEEEEW
WWWEEEEEEWEEEWWEEWWEW
WEEEWEEEEEWEWEWEEWEEW
WEEEEEWWEEEEWEEEWEWWW
WEEWWEWEEEEEEWEWEEWEW
WEWEEEWWWEEEEWEEEEEWW
WEWEEWWWEWEEWEWEEEWEW
WWWEEWEEEWWEEEEEWWEEW
WEEEWWWEEEEWEEEEEWEEW
WEEEEWEWEEWEEEEWWWEEW
WEWEEEEEWEWEWWEEEEEEW
WWWWWWWWWWWWWWWWWWWWW

WWWWWWWWWWWWWWWWWWWWW
WWEWWEWWEEWEEWEEEWEEW
WWWEEEEEEEEEEEEEWWWWW
WWWWEEEWWEEEWEWEEEEEW
WGEEEWEWWEEEEEEEWWYEW
WWEEEWEEWWWEEEWEEEEEW
WWEEEWEWEEEEWEWEEWEEW
WWEEEEWEWEEEEWEEWEWEW
WEWEEYEEEWEEWEEEEEWWW
WEEWWWEWEEWWEWWEEEEEW
WWWEEEEEEWEEEWWEEWWEW
WEEEWEEEEEWEWEWEEWEEW
WEEEEEWWEEEEWEEEWEWWW
WEEWWEWEEEEEEWEWEEWEW
WEWEEEWWWEEEEWEEEEEWW
WEWEEWWWEWEEWEWEEEWEW
WWWEEWEEEWWEEEEEWWEEW
WEEEWWWEEEEWEEEEEWEEW
WEEEEWEWEEWEEEEWWWEEW
WEWEEEEEWEWEWWEEEEEEW
WWWWWWWWWWWWWWWWWWWWW