WWWWWWWWWWWWWWWWWWWWW
WWEWWEWWEEWEEWEEEWEEW
WWWEEEEEEEEEEEEEWWWWW
WWWWEEEWWEEEWEWEEEEEW
WGEEEEEEEEEEEEEEWWEEW
WWEEEWEEEEEEEEWEEEEEW
WWEEEWEWEEEEWEWEEWEEW
WWEEEEWEWEEEEWEEWEWEW
WEWEEEEEEWEEWEEEEEWWW
WEEEEEEEEEEEEEEEEEEEW
WWWEEEEEEWEEEWWEEWWEW
WEEEWEEEEEWEWEWEEWEEW
WEEEEEWWEEEEWEEEWEWWW
WEEWWEWEEEEEEWEWEEWEW
WEWEEEWWWEEEEWEEEEEWW
WEWEEWWWEWEEWEWEEEWEW
WWWEEWEEEWWEEEEEWWEEW
WEEEEEEEEEEWEEEEEWEEW
WEEEEWEWEEWEEEEWWWEEW
WEWEEEEEWEWEWWEEEEEEW
WWWWWWWWWWWWWWWWWWWWW

WWWWWWWWWWWWWWWWWWWWW
WWEWWEWWEEWEEWEEEWEEW
WWWEEEEEEEEEEEEEWWWWW
WWWWEEEWWEEEWEWEEEEEW
WGEEEEEEEEEEEEEEWWEEW
WWEEEWEEEEEEEEWEEEEEW
WWEEEWEWEEEEWEWEEWEEW
WWEEEEWEWEEEEWEEWEWEW
WEWEEEEEEWEEWEEEEEWWW
WEEEEEEEEEEEEEEEEEEEW
WWWEEEEEEWEEEWWEEWWEW
WEEEWEEEEEWEWEWEEWEEW
WEEEEEWWEEEEWEEEWEWWW
WEEWWEWEEEEEEWEWEEWEW
WEWEEEWWWEEEEWEEEEEWW
WEWEEWWWEWEEWEWEEEWEW
WWWEEWEEEWWEEEEEWWEEW
WEEEEEEEEEEWEEEEEWEEW
WEEEEWEWEEWEEEEWWWEEW
WEWEEEEEWEWEWWEEEEEEW
WWWWWWWWWWWWWWWWWWWWW