WWWWWWWWWWWW
WEKEWEEKEEEW
WEEEWEEEWDEW
WEEEKEDEWGEW
WKWEWEEEWEEW
WWWWWWWWWWWW

WWWWWWWWWWWW
WEYEWEEYEEEW
WEEEWEEEWYEW
WEEEYEYEWGEW
WYWEWEEEWEEW
WWWWWWWWWWWW