WWWWWWWWWWW
WEWEEEKEEWW
WEWEEWWWEEW
WEWEEEEWEEW
WEWEEEEWEEW
WEWWWWEWEEW
WKWEEWEWEEW
WEWEDEEWEEW
WEWWEEEWEGW
WEEEEWEWEEW
WWWWWWWWWWW

WWWWWWWWWWW
WEWEEEYEEWW
WEWEEWWWEEW
WEWEEEEWEEW
WEWEEEEWEEW
WEWWWWEWEEW
WYWEEWEWEEW
WEWEYEEWEEW
WEWWEEEWEGW
WEEEEWEWEEW
WWWWWWWWWWW