WWWWWWWWWWWWWWWWWWWW
WEEEELEKKEEEEEEEEEEW
WEEEELWWWWWEEKKEEEEW
WWWEELEEKEEEEEEEEEEW
WEEEELEOOEEEEEEEEEEW
WEEEEEEEWWWWWWWWWWWW
WOOOOLWWWEEEKKEEEEEW
WEEEEEEEWEEEEEEEEEEW
WEEEEEEEWEEEEWWWWEEW
WEWEOOEEWEEEWWWWEEEW
WEWEEEEEWEEEEEEEEEEW
WEWEEEEEWEEEELLLLLLW
WEEEKKEEWEEEEEEEEEEW
WEEEEEEEWWWWWWOOWWWW
WEEEEEEEOEEEEEEEEEEW
WWWWWWWLLEEOOEEEEEEW
WEEEEEOEEEEEKKKEEEEW
WEEEEWWWEEEEEEEEEEEW
WEEEEEEWEEEEEEEEEEEW
WWWWWWWWWWWWWWWWWWWW

WWWWWWWWWWWWWWWWWWWW
WEEEELEYYEEEEEEEEEEW
WEEEELWWWWWEEYYEEEEW
WWWEELEEYEEEEEEEEEEW
WEEEELEYYEEEEEEEEEEW
WEEEEEEEWWWWWWWWWWWW
WYYYYLWWWEEEYYEEEEEW
WEEEEEEEWEEEEEEEEEEW
WEEEEEEEWEEEEWWWWEEW
WEWEYYEEWEEEWWWWEEEW
WEWEEEEEWEEEEEEEEEEW
WEWEEEEEWEEEELLLLLLW
WEEEYYEEWEEEEEEEEEEW
WEEEEEEEWWWWWWYYWWWW
WEEEEEEEYEEEEEEEEEEW
WWWWWWWLLEEYYEEEEEEW
WEEEEEYEEEEEYYYEEEEW
WEEEEWWWEEEEEEEEEEEW
WEEEEEEWEEEEEEEEEEEW
WWWWWWWWWWWWWWWWWWWW