WWWWWWWWWWWWWWWWWWWW
WKKEEEEEEWEEKKEEEEEW
WEEEEEEEEWEEEEEEEEEW
WEEELLEEEWEEOOEEEWWW
WEEEEEEEEOEEEEEEEEEW
WEEEWWWWWWEEEEEEEEEW
WEEEWEEEEWWWWWLLWWOW
WEEEOEEEEWEKEWEEEEEW
WEEEWEEOELEKEWEEEWWW
WEEEWEEOELEEEEEEEEEW
WWWOWWWWWWWLLLWWWOWW
WKKEEEEWWWWWWWEEEEEW
WEEEEEEWEEEEELEEEEEW
WLLLOWWWWEEEELEEEEEW
WEEEEEEEEOEEWWEEEEEW
WEEEEKEEWEEWWWEEEEEW
WEEEKEELEEEWWWEEEEEW
WEKKEEELEEWEEEEEEEEW
WEEEEEEWEEOEEEKKEEEW
WWWWWWWWWWWWWWWWWWWW

WWWWWWWWWWWWWWWWWWWW
WYYEEEEEEWEEYYEEEEEW
WEEEEEEEEWEEEEEEEEEW
WEEELLEEEWEEYYEEEWWW
WEEEEEEEEYEEEEEEEEEW
WEEEWWWWWWEEEEEEEEEW
WEEEWEEEEWWWWWLLWWYW
WEEEYEEEEWEYEWEEEEEW
WEEEWEEYELEYEWEEEWWW
WEEEWEEYELEEEEEEEEEW
WWWYWWWWWWWLLLWWWYWW
WYYEEEEWWWWWWWEEEEEW
WEEEEEEWEEEEELEEEEEW
WLLLYWWWWEEEELEEEEEW
WEEEEEEEEYEEWWEEEEEW
WEEEEYEEWEEWWWEEEEEW
WEEEYEELEEEWWWEEEEEW
WEYYEEELEEWEEEEEEEEW
WEEEEEEWEEYEEEYYEEEW
WWWWWWWWWWWWWWWWWWWW