WWWWWWWWWWWWWWWWWWWW
WEEEEEKKEEEEEEEEEEEW
WEEEEEEEEEEEEEEEEEEW
WWWWWWWWWLLOOEEEEEEW
WEEEOEEEKEEEEEEEEEEW
WEEEOEEEWEEEEEEEEWWW
WEEEEEEEWEEEEKEEEEEW
WEEEKEEEWEEEEKEEEEEW
WEEEEEEEWEEEEEEEEEEW
WEEEEEEEEEEEEEEEEEEW
WEEEEWWWWWWLLOOWWWWW
WEEEEEEEEEEEEEEEEEEW
WEEEEEEEEEWEEEEEEEEW
WWWEEEEEEEWWEEEEOOEW
WEEEEKKEEEEEEEEEEEEW
WEEEEEEEEEWWEEEEEEEW
WEEEEEEEWEWWEEEEEEEW
WEEEEEEEOEEEEEEWWWWW
WEEEEEEEOEEEEEEEEEEW
WWWWWWWWWWWWWWWWWWWW

WWWWWWWWWWWWWWWWWWWW
WEEEEEYYEEEEEEEEEEEW
WEEEEEEEEEEEEEEEEEEW
WWWWWWWWWLLYYEEEEEEW
WEEEYEEEYEEEEEEEEEEW
WEEEYEEEWEEEEEEEEWWW
WEEEEEEEWEEEEYEEEEEW
WEEEYEEEWEEEEYEEEEEW
WEEEEEEEWEEEEEEEEEEW
WEEEEEEEEEEEEEEEEEEW
WEEEEWWWWWWLLYYWWWWW
WEEEEEEEEEEEEEEEEEEW
WEEEEEEEEEWEEEEEEEEW
WWWEEEEEEEWWEEEEYYEW
WEEEEYYEEEEEEEEEEEEW
WEEEEEEEEEWWEEEEEEEW
WEEEEEEEWEWWEEEEEEEW
WEEEEEEEYEEEEEEWWWWW
WEEEEEEEYEEEEEEEEEEW
WWWWWWWWWWWWWWWWWWWW