WWWWWWWWWWWWWWWWWWWW
WKKEEWEEEEKKEEEKEEEW
WEEEEWEEEEEOEEEEEEEW
WEEEEWEEEEEEWWWWLLLW
WEEEEWEEEEEEEEEEEEEW
WEEOOWEEEEEEEEEEEEEW
WEEEEWWWWOWWWWWWWWWW
WEEEEOEEEEEEEEEEEEEW
WEEEEOEEEEEEWWWEEEWW
WEEEEOEEEEEEEWEEEEEW
WEEEELEEEEEEEEEEEEEW
WEEEELWWOOWWWWWLLWWW
WEEEEWEEEEEWEEEEEEEW
WWWWWWWWEEEWEEEEEEEW
WEEEEWEEEEEWEEKEEEEW
WEEEEWEEEEEWEEKEEEEW
WEEKKEEEEEEOWWWEEEEW
WEEEEEEEEEEOEEEEEEEW
WEEEEEEEEEEWEKKEEEEW
WWWWWWWWWWWWWWWWWWWW

WWWWWWWWWWWWWWWWWWWW
WYYEEWEEEEYYEEEYEEEW
WEEEEWEEEEEYEEEEEEEW
WEEEEWEEEEEEWWWWLLLW
WEEEEWEEEEEEEEEEEEEW
WEEYYWEEEEEEEEEEEEEW
WEEEEWWWWYWWWWWWWWWW
WEEEEYEEEEEEEEEEEEEW
WEEEEYEEEEEEWWWEEEWW
WEEEEYEEEEEEEWEEEEEW
WEEEELEEEEEEEEEEEEEW
WEEEELWWYYWWWWWLLWWW
WEEEEWEEEEEWEEEEEEEW
WWWWWWWWEEEWEEEEEEEW
WEEEEWEEEEEWEEYEEEEW
WEEEEWEEEEEWEEYEEEEW
WEEYYEEEEEEYWWWEEEEW
WEEEEEEEEEEYEEEEEEEW
WEEEEEEEEEEWEYYEEEEW
WWWWWWWWWWWWWWWWWWWW