WWWWWWWWWWWWWWWWWWWW
WEEEEEKKEEEEEEEEEEEW
WEEEEEEEEEEEEEEEEEEW
WWWWWWWWWLLOOWWWWWWW
WEEEOEEEKEEEEEEEEEEW
WEEEOEEEWEEEEEEEEWWW
WEEEEEEEWEEEEKEEEEEW
WEEEKEEEWEEEEKEEEEEW
WEEEEEEEWEEEEEEEEEEW
WEEEEEEEOEEEEEEEEEEW
WWWWOOWWWWWWLLOOWWWW
WEEEEEEEEEWEEEEEEEEW
WEEEEEEEEEWEEEEEEEEW
WWWEEEEEEEWWEEEEOOEW
WEEEEKKEEEWEEEEEEEEW
WEEEEEEEEEWWEEEEEEEW
WEEEEEEEWOWWEEEEEEEW
WEEEEEEEOEEEEEEWWWWW
WEEEEEEEOEEEEEEEEEEW
WWWWWWWWWWWWWWWWWWWW

WWWWWWWWWWWWWWWWWWWW
WEEEEEYYEEEEEEEEEEEW
WEEEEEEEEEEEEEEEEEEW
WWWWWWWWWLLYYWWWWWWW
WEEEYEEEYEEEEEEEEEEW
WEEEYEEEWEEEEEEEEWWW
WEEEEEEEWEEEEYEEEEEW
WEEEYEEEWEEEEYEEEEEW
WEEEEEEEWEEEEEEEEEEW
WEEEEEEEYEEEEEEEEEEW
WWWWYYWWWWWWLLYYWWWW
WEEEEEEEEEWEEEEEEEEW
WEEEEEEEEEWEEEEEEEEW
WWWEEEEEEEWWEEEEYYEW
WEEEEYYEEEWEEEEEEEEW
WEEEEEEEEEWWEEEEEEEW
WEEEEEEEWYWWEEEEEEEW
WEEEEEEEYEEEEEEWWWWW
WEEEEEEEYEEEEEEEEEEW
WWWWWWWWWWWWWWWWWWWW