WWWWWWWWWWWWWWWWWWWW
WKKEEWEEEEKKEEEEEEEW
WEEEEWEEEEEEEEEEEEEW
WEEEEWEEEEEEWWWWLLLW
WEEEEWEEEEEEEEEEEEEW
WEEOOWEEEEEEEEEEEEEW
WEEEEWEEEWWWWWWWWWWW
WEEEEOEEEEEEEEEEEEEW
WEEEEOEEEEEEWWWEEEWW
WEEEEOEEEEEEEWEEEEEW
WEEEELEEEEEEEEEEEEEW
WEEEELEEOOWWWWWLLWWW
WEEEEEEEEEEWEEEEEEEW
WWWWWWWWEEEWEEEEEEEW
WEEEEWEEEEEWEEKEEEEW
WEEEEWEEEEEWEEKEEEEW
WEEKKEEEEEEOWWWEEEEW
WEEEEEEEEEEOEEEEEEEW
WEEEEEEEEEEEEKKEEEEW
WWWWWWWWWWWWWWWWWWWW

WWWWWWWWWWWWWWWWWWWW
WYYEEWEEEEYYEEEEEEEW
WEEEEWEEEEEEEEEEEEEW
WEEEEWEEEEEEWWWWLLLW
WEEEEWEEEEEEEEEEEEEW
WEEYYWEEEEEEEEEEEEEW
WEEEEWEEEWWWWWWWWWWW
WEEEEYEEEEEEEEEEEEEW
WEEEEYEEEEEEWWWEEEWW
WEEEEYEEEEEEEWEEEEEW
WEEEELEEEEEEEEEEEEEW
WEEEELEEYYWWWWWLLWWW
WEEEEEEEEEEWEEEEEEEW
WWWWWWWWEEEWEEEEEEEW
WEEEEWEEEEEWEEYEEEEW
WEEEEWEEEEEWEEYEEEEW
WEEYYEEEEEEYWWWEEEEW
WEEEEEEEEEEYEEEEEEEW
WEEEEEEEEEEEEYYEEEEW
WWWWWWWWWWWWWWWWWWWW