WWWWWWWWWWWWWWWWWWWW
WKKEEEEEEWEEKKEEEEEW
WEEEEEEEEWEEEEEEEEEW
WEEEEEEEEWEEOOEEEWWW
WEEEEEEEEEEEEEEEEEEW
WEEEWWEEEWEEEEEEEEEW
WEEEWEEEEWWWWWLLEEEW
WEEEEEEEEWEEEKEEEEEW
WEEEWEEOELEEEKEEEWWW
WEEEWEEOELEEEEEEEEEW
WWWEWWWWWWWLLLWWWOWW
WEEEEEEWWWWWWWEEEEEW
WEEEEEEWEEEEEEEEEEEW
WLLLOOWWEEEEEEEEEEEW
WEEEEEEEEEEEWWEEEEEW
WEEEEKEWEEEEWWEEEEEW
WEEEKEELEEEEWWEEEEEW
WEKKEEELEEOEEEEEEEEW
WEEEEEEWEEOEEEKKEEEW
WWWWWWWWWWWWWWWWWWWW

WWWWWWWWWWWWWWWWWWWW
WYYEEEEEEWEEYYEEEEEW
WEEEEEEEEWEEEEEEEEEW
WEEEEEEEEWEEYYEEEWWW
WEEEEEEEEEEEEEEEEEEW
WEEEWWEEEWEEEEEEEEEW
WEEEWEEEEWWWWWLLEEEW
WEEEEEEEEWEEEYEEEEEW
WEEEWEEYELEEEYEEEWWW
WEEEWEEYELEEEEEEEEEW
WWWEWWWWWWWLLLWWWYWW
WEEEEEEWWWWWWWEEEEEW
WEEEEEEWEEEEEEEEEEEW
WLLLYYWWEEEEEEEEEEEW
WEEEEEEEEEEEWWEEEEEW
WEEEEYEWEEEEWWEEEEEW
WEEEYEELEEEEWWEEEEEW
WEYYEEELEEYEEEEEEEEW
WEEEEEEWEEYEEEYYEEEW
WWWWWWWWWWWWWWWWWWWW