WWWWWWWWWWWWWWWWWWWW
WKKEEEEEEWEEKKEEEEEW
WEEEEEEEEWEEEEEEEEEW
WEEEEEEEEWEEOOEEEWWW
WEEEEEEEEOEEEEEEEEEW
WEEEWWEEEWEEEEEEEEEW
WEEEWEEEEWWWWWLLOOOW
WEEEEEEEEWEEEKEEEEEW
WEEEWEEOELEEEKEEEWWW
WEEEWEEOELEEEEEEEEEW
WWWOWWWWWWWLLLWWWOWW
WEEEEEEWWWWWWWEEEEEW
WEEEEEEWEEEEEEEEEEEW
WLLLOOWWWEEEEEEEEEEW
WEEEEEEEEOEEWWEEEEEW
WEEEEKEEWEEWWWEEEEEW
WEEEKEELEEEEWWEEEEEW
WEKKEEELEEOEEEEEEEEW
WEEEEEEWEEOEEEKKEEEW
WWWWWWWWWWWWWWWWWWWW

WWWWWWWWWWWWWWWWWWWW
WYYEEEEEEWEEYYEEEEEW
WEEEEEEEEWEEEEEEEEEW
WEEEEEEEEWEEYYEEEWWW
WEEEEEEEEYEEEEEEEEEW
WEEEWWEEEWEEEEEEEEEW
WEEEWEEEEWWWWWLLYYYW
WEEEEEEEEWEEEYEEEEEW
WEEEWEEYELEEEYEEEWWW
WEEEWEEYELEEEEEEEEEW
WWWYWWWWWWWLLLWWWYWW
WEEEEEEWWWWWWWEEEEEW
WEEEEEEWEEEEEEEEEEEW
WLLLYYWWWEEEEEEEEEEW
WEEEEEEEEYEEWWEEEEEW
WEEEEYEEWEEWWWEEEEEW
WEEEYEELEEEEWWEEEEEW
WEYYEEELEEYEEEEEEEEW
WEEEEEEWEEYEEEYYEEEW
WWWWWWWWWWWWWWWWWWWW