WWWWWWWWWWWWWWWWWWWW
WEEEELEKKEEEEEEEEEEW
WEEEELWWWWWEEKKEEEEW
WWWEELEEEEEEEEEEEEEW
WEEEELEOOEEEEEEEEEEW
WEEEEEEEWWWWWWWWWWWW
WOOOOLEEEEEEKKEEEEEW
WEEEEEEEWEEEEEEEEEEW
WEEEEEEEWEEEEWWWWEEW
WEWEOOEEWEEEWWWWEEEW
WEWEEEEEWEEEEEEEEEEW
WEWEEEEEWEEEELLLLLLW
WEEEKKEEWEEEEEEEEEEW
WEEEEEEEWEEWWWLLWWWW
WEEEEEEEEEEEEEEEEEEW
WWWWWWWLLEEOOEEEEEEW
WEEEEEOEEEEEKKKEEEEW
WEEEEWWWEEEEEEEEEEEW
WEEEEEEWEEEEEEEEEEEW
WWWWWWWWWWWWWWWWWWWW

WWWWWWWWWWWWWWWWWWWW
WEEEELEYYEEEEEEEEEEW
WEEEELWWWWWEEYYEEEEW
WWWEELEEEEEEEEEEEEEW
WEEEELEYYEEEEEEEEEEW
WEEEEEEEWWWWWWWWWWWW
WYYYYLEEEEEEYYEEEEEW
WEEEEEEEWEEEEEEEEEEW
WEEEEEEEWEEEEWWWWEEW
WEWEYYEEWEEEWWWWEEEW
WEWEEEEEWEEEEEEEEEEW
WEWEEEEEWEEEELLLLLLW
WEEEYYEEWEEEEEEEEEEW
WEEEEEEEWEEWWWLLWWWW
WEEEEEEEEEEEEEEEEEEW
WWWWWWWLLEEYYEEEEEEW
WEEEEEYEEEEEYYYEEEEW
WEEEEWWWEEEEEEEEEEEW
WEEEEEEWEEEEEEEEEEEW
WWWWWWWWWWWWWWWWWWWW