WWWWWWWWWWWWWWWWWWWW
WWWEEEEEEWEEKKEEEEEW
WEEEEKKEEWEEEEEEEEEW
WEEEWWLLEWEEOOEEEWWW
WWWEEEEEEWEEEEEEEEEW
WEEEWWWWWOEEEEEEEEEW
WEKEWEEEEWWWOWLLWWWW
WEKEOEEEEWEEEKEEEEEW
WEEEWEEEELEEEKEEEWWW
WEEEWEEEELEEEEEEEEEW
WWWOWWWWWWWLLLWWWOWW
WEEEEEEWWWWWWWEEEEEW
WEEEKEEWEEEEEEEEEEEW
WLLLOWWWWEEEEEELLLEW
WEEEEEEEEOEEWWEEEEEW
WEKEEWEEWEEWWWEEKEEW
WEKELEELEEEEWWEEKEEW
WEWWEEELEEOEEEEEEEEW
WEEEEEEWEEWEEEKKEEEW
WWWWWWWWWWWWWWWWWWWW

WWWWWWWWWWWWWWWWWWWW
WWWEEEEEEWEEYYEEEEEW
WEEEEYYEEWEEEEEEEEEW
WEEEWWLLEWEEYYEEEWWW
WWWEEEEEEWEEEEEEEEEW
WEEEWWWWWYEEEEEEEEEW
WEYEWEEEEWWWYWLLWWWW
WEYEYEEEEWEEEYEEEEEW
WEEEWEEEELEEEYEEEWWW
WEEEWEEEELEEEEEEEEEW
WWWYWWWWWWWLLLWWWYWW
WEEEEEEWWWWWWWEEEEEW
WEEEYEEWEEEEEEEEEEEW
WLLLYWWWWEEEEEELLLEW
WEEEEEEEEYEEWWEEEEEW
WEYEEWEEWEEWWWEEYEEW
WEYELEELEEEEWWEEYEEW
WEWWEEELEEYEEEEEEEEW
WEEEEEEWEEWEEEYYEEEW
WWWWWWWWWWWWWWWWWWWW