WWWWWWWWWWWWWWWWWWWW
WEKKEEEWEEEKEEEEEEEW
WEEEEEEWEEEKEEEEEEEW
WEEEEWWWEEEEWWEEEEEW
WEEEEEELEEEEWEEEEEEW
WEEEEEEWEEEEEEEEEEEW
WEEEEEEWEEEEEOEEEEEW
WEEEEWEEEEEEEOEEEEEW
WEEEEWWWWWWWWWWWWWWW
WEEEEEEEEEEEEEEEEEEW
WWWWWWWWWLLLOOEEEEEW
WKKEEEEEEKEEEEEEEEEW
WEEEEEWEEKEEEEKEEEEW
WEEEEEWEEEEEKKEEEEEW
WEEEWWWEEEEEEEEEEEEW
WEEEEEWEEEWWWWWWEEEW
WEEEEEWEEEEEEEEEEEEW
WEEEEELEEEEEEOEEEEEW
WEEKKELEEEEEEOEEEEEW
WWWWWWWWWWWWWWWWWWWW

WWWWWWWWWWWWWWWWWWWW
WEYYEEEWEEEYEEEEEEEW
WEEEEEEWEEEYEEEEEEEW
WEEEEWWWEEEEWWEEEEEW
WEEEEEELEEEEWEEEEEEW
WEEEEEEWEEEEEEEEEEEW
WEEEEEEWEEEEEYEEEEEW
WEEEEWEEEEEEEYEEEEEW
WEEEEWWWWWWWWWWWWWWW
WEEEEEEEEEEEEEEEEEEW
WWWWWWWWWLLLYYEEEEEW
WYYEEEEEEYEEEEEEEEEW
WEEEEEWEEYEEEEYEEEEW
WEEEEEWEEEEEYYEEEEEW
WEEEWWWEEEEEEEEEEEEW
WEEEEEWEEEWWWWWWEEEW
WEEEEEWEEEEEEEEEEEEW
WEEEEELEEEEEEYEEEEEW
WEEYYELEEEEEEYEEEEEW
WWWWWWWWWWWWWWWWWWWW