WWWWWWWWWWWWWWWWWWWW
WEKKEEEWEEEKEEEEEEEW
WEEEEEEWEEEKEEEEEEEW
WEEEEWWWEEEEWWEEEEEW
WEEEEEELEEEEWEEEEEEW
WEEEEEEWEEEEEEEEEEEW
WEEEEEEWEEEEEOEEEEEW
WEEEEWEEEEEEEOEEEEEW
WEEEEWWWWWWWWWWWWWWW
WEEEEEEEEEEEEEEEEEEW
WWWWWWWWWLLLOOWWWWWW
WKKEEEEEEKEEEEWEEEEW
WEEEEEWEEKEEEEKEEEEW
WEEEEEWEEEEEKKEEEEEW
WEEEWWWEEEEEEWEEEEEW
WEEEEEWEEEWWWWWWEEEW
WEEEEEWEEEEEEWEEEEEW
WEEEEELEEEEEEOEEELEW
WEEKKELEEEEEEOEEEEEW
WWWWWWWWWWWWWWWWWWWW

WWWWWWWWWWWWWWWWWWWW
WEYYEEEWEEEYEEEEEEEW
WEEEEEEWEEEYEEEEEEEW
WEEEEWWWEEEEWWEEEEEW
WEEEEEELEEEEWEEEEEEW
WEEEEEEWEEEEEEEEEEEW
WEEEEEEWEEEEEYEEEEEW
WEEEEWEEEEEEEYEEEEEW
WEEEEWWWWWWWWWWWWWWW
WEEEEEEEEEEEEEEEEEEW
WWWWWWWWWYYYYYWWWWWW
WYYEEEEEEYEEEEWEEEEW
WEEEEEWEEYEEEEYEEEEW
WEEEEEWEEEEEYYEEEEEW
WEEEWWWEEEEEEWEEEEEW
WEEEEEWEEEWWWWWWEEEW
WEEEEEWEEEEEEWEEEEEW
WEEEEELEEEEEEYEEELEW
WEEYYELEEEEEEYEEEEEW
WWWWWWWWWWWWWWWWWWWW