WWWWWW
WEEKEW
WEEEEW
WEWEEW
WWWWWW

WWWWWW
WEEYEW
WEEEEW
WEWEEW
WWWWWW