WWWWWW
WEEKKW
WEEEEW
WEWEWW
WWWWWW

WWWWWW
WEEYYW
WEEEEW
WEWEWW
WWWWWW
