WWWWWW
WELEEW
WEEEEW
WEKKEW
WWWWWW

WWWWWW
WELEEW
WEEEEW
WEYYEW
WWWWWW