WWWWWW
WEKKEW
WEEEEW
WEEOEW
WWWWWW

WWWWWW
WEYYEW
WEEEEW
WEEYEW
WWWWWW