WWWWWW
WEEKKW
WEEEEW
WEOEEW
WWWWWW

WWWWWW
WEEYYW
WEEEEW
WEYEEW
WWWWWW