WWWWWW
WEEEOW
WEEEEW
WEKKEW
WWWWWW

WWWWWW
WEEEYW
WEEEEW
WEYYEW
WWWWWW