WWWWWWWWWWWW
WEEEWEEEDBEW
WEEEWEEEWEEW
WEEEEEEEWEEW
WEKEWEEEWEEW
WWWWWWWWWWWW

WWWWWWWWWWWW
WEEEWEEEYYEW
WEEEWEEEWEEW
WEEEEEEEWEEW
WEYEWEEEWEEW
WWWWWWWWWWWW