WWWWWWWWWWWW
WEEEWEEEEBEW
WEEEWEEEWEEW
WEEEOEEEWEEW
WEEEWEEEWEEW
WWWWWWWWWWWW

WWWWWWWWWWWW
WEEEWEEEEYEW
WEEEWEEEWEEW
WEEEBEEEWEEW
WEEEWEEEWEEW
WWWWWWWWWWWW