WWWWWWWWWWW
WEWEEEEOOEW
WEWEEEEEEEW
WEWEOEEWEEW
WEWEEEEWEEW
WEEEEOOWEEW
WEEEOEEWEEW
WOOEEEEWEEW
WEEOOEEWEGW
WEEEEEEWEEW
WWWWWWWWWWW

WWWWWWWWWWW
WEWEEEEYYEW
WEWEEEEEEEW
WEWEYEEWEEW
WEWEEEEWEEW
WEEEEYYWEEW
WEEEYEEWEEW
WYYEEEEWEEW
WEEYYEEWEGW
WEEEEEEWEEW
WWWWWWWWWWW