WWWWWWWWWWW
WWWEWWWWWWW
WWWEWWWWWWW
WWWEWWWWWWW
WWWEWWWWWWW
WWWEWWWWWWW
WWWEWWWWWWW
WWWEWWWWWWW
WWWGWWWWWWW
WWWWWWWWWWW
WWWWWWWWWWW

WWWWWWWWWWW
WWWEWWWWWWW
WWWEWWWWWWW
WWWEWWWWWWW
WWWEWWWWWWW
WWWEWWWWWWW
WWWEWWWWWWW
WWWEWWWWWWW
WWWGWWWWWWW
WWWWWWWWWWW
WWWWWWWWWWW