WWWWWWWWWWW
WEEEEEEEEEW
WEEEEEEEEEW
WEEEEEEEEEW
WEEEEEEEEEW
WEEEEEEEEEW
WEEEEEEEEEW
WEEEEEEEEEW
WEEEEEEEEGW
WEEEEEEEEEW
WWWWWWWWWWW

WWWWWWWWWWW
WEEEEEEEEEW
WEEEEEEEEEW
WEEEEEEEEEW
WEEEEEEEEEW
WEEEEEEEEEW
WEEEEEEEEEW
WEEEEEEEEEW
WEEEEEEEEGW
WEEEEEEEEEW
WWWWWWWWWWW
