WWWWWWWWWWW
WWWWWWWWWWW
WWWWWWWWWWW
WWWWWWWWWWW
WWWWWWWWWWW
WWWWWWWWWWW
WWWWWWWWWWW
WWWWWWWWWWW
WSEEKEEDEGW
WEEEEEEEEEW
WWWWWWWWWWW

WWWWWWWWWWW
WWWWWWWWWWW
WWWWWWWWWWW
WWWWWWWWWWW
WWWWWWWWWWW
WWWWWWWWWWW
WWWWWWWWWWW
WWWWWWWWWWW
WSEEYEEYEGW
WEEEEEEEEEW
WWWWWWWWWWW