WWWWWWWWWWW
WEEEEEEEEEW
WWWEEWWEEEW
WEEEEEEEEEW
WEEEEEEEEEW
WWWWWEEEEEW
WEEEEEEEEEW
WEEEEEWWWWW
WEWWEEEEEGW
WEEEEEEEEEW
WWWWWWWWWWW

WWWWWWWWWWW
WEEEEEEEEEW
WWWEEWWEEEW
WEEEEEEEEEW
WEEEEEEEEEW
WWWWWEEEEEW
WEEEEEEEEEW
WEEEEEWWWWW
WEWWEEEEEGW
WEEEEEEEEEW
WWWWWWWWWWW