WWWWWWWWWWW
WEWOOEEEEEW
WEEEEEWWEEW
WEEOEEEWEEW
WEWEEEEWEEW
WEEEEEEWEEW
WEOEEEEWEEW
WOEEEEEWEEW
WEOEOEEWEGW
WEEEEEEWEEW
WWWWWWWWWWW

WWWWWWWWWWW
WEWYYEEEEEW
WEEEEEWWEEW
WEEYEEEWEEW
WEWEEEEWEEW
WEEEEEEWEEW
WEEEEEEWEEW
WYEEEEEWEEW
WEYEYEEWEGW
WEEEEEEWEEW
WWWWWWWWWWW