WWWWWWWWWWW
WEWKDEEEEEW
WEEEEEWWEEW
WEEDEEEWEEW
WEWEEEEWEEW
WEEEEEEWEEW
WEKEEEEWEEW
WKEEEEEWEEW
WEKEDEEWEGW
WEEEEEEWEEW
WWWWWWWWWWW

WWWWWWWWWWW
WEWYYEEEEEW
WEEEEEWWEEW
WEEYEEEWEEW
WEWEEEEWEEW
WEEEEEEWEEW
WEYEEEEWEEW
WYEEEEEWEEW
WEYEYEEWEGW
WEEEEEEWEEW
WWWWWWWWWWW