WWWWWWWWWWW
WEEEWEEEEEW
WEEEWEEEEEW
WEEEWEEWEWW
WEWEWEEWEWW
WEWEWEEWEEW
WEWEWEEWEEW
WEWEEEEWEEW
WEWEEEEWEGW
WEWEEEEWEEW
WWWWWWWWWWW

WWWWWWWWWWW
WEEEWEEEEEW
WEEEWEEEEEW
WEEEWEEWEWW
WEWEWEEWEWW
WEWEWEEWEEW
WEWEWEEWEEW
WEWEEEEWEEW
WEWEEEEWEGW
WEWEEEEWEEW
WWWWWWWWWWW