WWWWWWWWWWW
WEEEEEEEEEW
WWWWWEEEEEW
WEEEEEEWEEW
WEEEWWWWEEW
WEEEEEEWEEW
WEEEEEEWEEW
WEEEWWWWEEW
WEEEEEEWEGW
WEEEEEEWEEW
WWWWWWWWWWW

WWWWWWWWWWW
WEEEEEEEEEW
WWWWWEEEEEW
WEEEEEEWEEW
WEEEWWWWEEW
WEEEEEEWEEW
WEEEEEEWEEW
WEEEWWWWEEW
WEEEEEEWEGW
WEEEEEEWEEW
WWWWWWWWWWW
