WWWWWWWWWWWW
WEEEWEEEDBEW
WEEEWEEEWEEW
WEEEOEEEWEEW
WEKEWEEEWEEW
WWWWWWWWWWWW

WWWWWWWWWWWW
WEEEWEEEYYEW
WEEEWEEEWEEW
WEEEBEEEWEEW
WEYEWEEEWEEW
WWWWWWWWWWWW