WWWWWWWWWWW
WWKEWEEKEEW
WWEEEWEEWDW
WEEKEDEWWGW
WKWEWEEEEEW
WWWWWWWWWWW

WWWWWWWWWWW
WWYEWEEYEEW
WWEEEWEEWYW
WEEYEYEWWGW
WYWEWEEEEEW
WWWWWWWWWWW
