WWWWWWWWWWW
WEEKEEEEKEW
WWwEEDEWEDW
WEEKEWEWGEW
WEWEEEWEEEW
WWWWWWWWWWW

WWWWWWWWWWW
WEEYEEEEYEW
WWwEEYEWEYW
WEEYEWEWGEW
WEWEEEWEEEW
WWWWWWWWWWW