WWWWWWWWWWW
WEEWEKEEDEW
WKEWDEEWEEW
WKEEEEEWGEW
WEEWEKEWEEW
WWWWWWWWWWW

WWWWWWWWWWW
WEEWEYEEYEW
WYEWYEEWEEW
WYEEEEEWGEW
WEEWEYEWEEW
WWWWWWWWWWW