WWWWWWWWWWW
WEKEWEEKEEW
WEEEWEEEWDW
WEEEKEDEWGW
WKWEWEEEWEW
WWWWWWWWWWW

WWWWWWWWWWW
WEYEWEEYEEW
WEEEWEEEWYW
WEEEYEYEWGW
WYWEWEEEWEW
WWWWWWWWWWW