WWWWWW
WEEEEW
WEOEEW
WEOEEW
WWWWWW

WWWWWW
WEEEEW
WEYEEW
WEYEEW
WWWWWW