WWWWWW
WWWWEW
WELLEW
WEELEW
WWWWWW

WWWWWW
WWWWEW
WELLEW
WEELEW
WWWWWW