WWWWWW
WEKKEW
WEEEEW
WEKKEW
WWWWWW

WWWWWW
WEYYEW
WEEEEW
WEYYEW
WWWWWW