WWWWWW
WEEEEW
WEWEEW
WEWEEW
WWWWWW

WWWWWW
WEEEEW
WEWEEW
WEWEEW
WWWWWW