WWWWWW
WEEEEW
WEKKEW
WEEEEW
WWWWWW

WWWWWW
WEEEEW
WEYYEW
WEEEEW
WWWWWW