WWWWWW
WEEOEW
WEEOEW
WEEEEW
WWWWWW

WWWWWW
WEEYEW
WEEYEW
WEEEEW
WWWWWW