WWWWWW
WEWEEW
WEEEWW
WEWEEW
WWWWWW

WWWWWW
WEWEEW
WEEEWW
WEWEEW
WWWWWW
