WWWWWW
WELLEW
WEELEW
WEEEEW
WWWWWW

WWWWWW
WELLEW
WEELEW
WEEEEW
WWWWWW