WWWWWWWWWWWWWWWWWWWW
WEEEEWEEEEEEEEEEEEEW
WEWEEWEEEEWWWWWWEEEW
WEWEEEEEWWEEEEEEEEEW
WEWEEWEEWWWWWEEEEEEW
WEWEEWEEWWEEEEEEWWEW
WEWEEWEEWWEEEEEEWWEW
WEWWWWEEWWEEEEEEWWEW
WEEEEWEEWWEEWEEEWWEW
WEEEEWEEWWEEWEEEWWEW
WEEEEWEEWWEEWEEEWWEW
WEEEEWEEWWEEWEEEWWEW
WWWWWWEEWWEEWEEEWWWW
WEEEEWEEEEEEWEEEEEEW
WEEEEEEEEEEEWEEWEEEW
WEEEEWWWWWWWWEEWEEEW
WEEEWWWWWEGEWEEWEEEW
WEEEWEEEEEEEEEEWEEEW
WEEEWEEEEEEEEEEWEEEW
WWWWWWWWWWWWWWWWWWWW

WWWWWWWWWWWWWWWWWWWW
WEEEEWEEEEEEEEEEEEEW
WEWEEWEEEEWWWWWWEEEW
WEWEEEEEWWEEEEEEEEEW
WEWEEWEEWWWWWEEEEEEW
WEWEEWEEWWEEEEEEWWEW
WEWEEWEEWWEEEEEEWWEW
WEWWWWEEWWEEEEEEWWEW
WEEEEWEEWWEEWEEEWWEW
WEEEEWEEWWEEWEEEWWEW
WEEEEWEEWWEEWEEEWWEW
WEEEEWEEWWEEWEEEWWEW
WWWWWWEEWWEEWEEEWWWW
WEEEEWEEEEEEWEEEEEEW
WEEEEEEEEEEEWEEWEEEW
WEEEEWWWWWWWWEEWEEEW
WEEEWWWWWEGEWEEWEEEW
WEEEWEEEEEEEEEEWEEEW
WEEEWEEEEEEEEEEWEEEW
WWWWWWWWWWWWWWWWWWWW