WWWWWWWWWWWWWWWWWWWW
WEEEEEEEEEEEWEEEEEEW
WEEEEEEEEEEEWEEEEWWW
WWWWWWEEEEEEWEEEEEEW
WEEEEEEEEEEEWEEEEEEW
WEEEEEWWEEEEEEEWWWWW
WEEEEEEEEEEEEEEEEEEW
WEEEEEEEWWWEEEEEEEEW
WEEEEEEEWWWEEEEEEEEW
WWWEEEEEWWWEEEEEEEEW
WEEEEEEEEEEEEEEEEEEW
WWEEWEEEEEEEEEEWWEEW
WEEEWEEEEEEEEEEWWEEW
WEEEGEEEEEWEEEEEEEEW
WWWWWWEEEEEWEEEWEEEW
WEEEEEEEEEWEEEEEEEEW
WEEEWWEEEEEEEEWEEEEW
WEEEWWEEEEEEEEEWEEEW
WEEEEEEEEEWEEEEEEEEW
WWWWWWWWWWWWWWWWWWWW

WWWWWWWWWWWWWWWWWWWW
WEEEEEEEEEEEWEEEEEEW
WEEEEEEEEEEEWEEEEWWW
WWWWWWEEEEEEWEEEEEEW
WEEEEEEEEEEEWEEEEEEW
WEEEEEWWEEEEEEEWWWWW
WEEEEEEEEEEEEEEEEEEW
WEEEEEEEWWWEEEEEEEEW
WEEEEEEEWWWEEEEEEEEW
WWWEEEEEWWWEEEEEEEEW
WEEEEEEEEEEEEEEEEEEW
WWEEWEEEEEEEEEEWWEEW
WEEEWEEEEEEEEEEWWEEW
WEEEGEEEEEWEEEEEEEEW
WWWWWWEEEEEWEEEWEEEW
WEEEEEEEEEWEEEEEEEEW
WEEEWWEEEEEEEEWEEEEW
WEEEWWEEEEEEEEEWEEEW
WEEEEEEEEEWEEEEEEEEW
WWWWWWWWWWWWWWWWWWWW