WWWWWWWWWWWWWWWWWWWW
WEEEEEEEEEEEEEEEEEEW
WWWWWWWWWWWWWWEEEEEW
WEEEEEEEEEEEEEEEEEEW
WEEEEWWWWWWWWWWWWWWW
WEEEEWEEEEEEEEEEEEEW
WEEEEWEEEGEEWWEWWEEW
WEEEEWWWWWWWWWEWEEEW
WEEWWEEEEEEEEEEWWWWW
WEEWEEEEEEEEEEEEEEEW
WEEWEEWEEEWWWWEEEEEW
WEEWEEWEEEEEEEWEEEEW
WEEWEEWEWEEEEEWEEEEW
WEEEEEWEWEEEEEEWEEEW
WWEEEEWEWEEEWEEWEEEW
WWWWWWWEWEEEWEEWEEEW
WEEEEEEEWEEEWEEWEEEW
WEEEEEEEWWWWWEEWEEEW
WEEEEEEEEEEEEEEEEEEW
WWWWWWWWWWWWWWWWWWWW

WWWWWWWWWWWWWWWWWWWW
WEEEEEEEEEEEEEEEEEEW
WWWWWWWWWWWWWWEEEEEW
WEEEEEEEEEEEEEEEEEEW
WEEEEWWWWWWWWWWWWWWW
WEEEEWEEEEEEEEEEEEEW
WEEEEWEEEGEEWWEWWEEW
WEEEEWWWWWWWWWEWEEEW
WEEWWEEEEEEEEEEWWWWW
WEEWEEEEEEEEEEEEEEEW
WEEWEEWEEEWWWWEEEEEW
WEEWEEWEEEEEEEWEEEEW
WEEWEEWEWEEEEEWEEEEW
WEEEEEWEWEEEEEEWEEEW
WWEEEEWEWEEEWEEWEEEW
WWWWWWWEWEEEWEEWEEEW
WEEEEEEEWEEEWEEWEEEW
WEEEEEEEWWWWWEEWEEEW
WEEEEEEEEEEEEEEEEEEW
WWWWWWWWWWWWWWWWWWWW