WWWWWWWWWWWWWWWWWWWW
WEEEWEEEEEEEEEEEEEEW
WEEEWEEEEWWEEEEEEWWW
WEEEWEEEEWWEEEEEEEEW
WEEEEEEEEEEEEEEEEEEW
WEEEEEWWEEEEWWWWWWWW
WEEEEEWWEEEEWWWWWWWW
WEEEEEEEEEEEWWWWWWWW
WEEEEEEEEEEEEEEEEEEW
WWWWWWWEEEEEEEEEEEEW
WWWWWWWEEEWWEEEEEEEW
WWWWWWWEEEWWEEEEEEEW
WEEEWEEEEEEEEEEWWEEW
WEEEEEEEEEEEEEEEEEEW
WWWWWWEEEEWEEEEEEEEW
WEEEEEEEEEWEEEWWEEEW
WEEEWWEEEEWEEEWWEEEW
WEEEWWEEEEWEEGEEEEEW
WEEEEEEEEEWEEEEEEEEW
WWWWWWWWWWWWWWWWWWWW

WWWWWWWWWWWWWWWWWWWW
WEEEWEEEEEEEEEEEEEEW
WEEEWEEEEWWEEEEEEWWW
WEEEWEEEEWWEEEEEEEEW
WEEEEEEEEEEEEEEEEEEW
WEEEEEWWEEEEWWWWWWWW
WEEEEEWWEEEEWWWWWWWW
WEEEEEEEEEEEWWWWWWWW
WEEEEEEEEEEEEEEEEEEW
WWWWWWWEEEEEEEEEEEEW
WWWWWWWEEEWWEEEEEEEW
WWWWWWWEEEWWEEEEEEEW
WEEEWEEEEEEEEEEWWEEW
WEEEEEEEEEEEEEEEEEEW
WWWWWWEEEEWEEEEEEEEW
WEEEEEEEEEWEEEWWEEEW
WEEEWWEEEEWEEEWWEEEW
WEEEWWEEEEWEEGEEEEEW
WEEEEEEEEEWEEEEEEEEW
WWWWWWWWWWWWWWWWWWWW
