WWWWWWWWWWWWWWWWWWWW
WEEEWEEEEEEEEEEEEEEW
WEEEWEEEEEEEEEEEEWWW
WEEEWEEEEEEEEEEEEEEW
WEEEEEEEEEEEEEEEEEEW
WEEEEEWWEEEEWWWWWWWW
WEEEEEEEEEEEEEEEEEEW
WEEEEEEEEEEEWWWWWWWW
WEEEEEEEEEEEEEEEEEEW
WWWWWWWEEEEEEEEEEEEW
WEEEEEEEEEWEEEEEEEEW
WWWWWWWEEEEEEEEEEEEW
WEEEWEEEEEEEEEEWWEEW
WEEEGEEEEEWEEEEEEEEW
WWWWWWEEEEEWEEEEEEEW
WEEEEEEEEEWEEEEEEEEW
WEEEWEEEEEEEEEWEEEEW
WEEEEEEEEEEEEEEWEEEW
WEEEEEEEEEWEEEEEEEEW
WWWWWWWWWWWWWWWWWWWW

WWWWWWWWWWWWWWWWWWWW
WEEEWEEEEEEEEEEEEEEW
WEEEWEEEEEEEEEEEEWWW
WEEEWEEEEEEEEEEEEEEW
WEEEEEEEEEEEEEEEEEEW
WEEEEEWWEEEEWWWWWWWW
WEEEEEEEEEEEEEEEEEEW
WEEEEEEEEEEEWWWWWWWW
WEEEEEEEEEEEEEEEEEEW
WWWWWWWEEEEEEEEEEEEW
WEEEEEEEEEWEEEEEEEEW
WWWWWWWEEEEEEEEEEEEW
WEEEWEEEEEEEEEEWWEEW
WEEEGEEEEEWEEEEEEEEW
WWWWWWEEEEEWEEEEEEEW
WEEEEEEEEEWEEEEEEEEW
WEEEWEEEEEEEEEWEEEEW
WEEEEEEEEEEEEEEWEEEW
WEEEEEEEEEWEEEEEEEEW
WWWWWWWWWWWWWWWWWWWW