WWWWWWWWWWWWWWWWWWWW
WEWEEEWEWEEWEEEEEEEW
WEWWEEEEWEEEEEWEEWWW
WEWEEEWEEEEEKWEEEWEW
WEWEDEEWEWWEEEEEWEEW
WEEEEDEWEEEWEEWEEEEW
WEWEWEEWEEEWEEEWWEEW
WEWEEWEWEWWWWEKEEGEW
WEEEEEWEEEEEDEEEWEEW
WWWEEEEEEEWWEEDEEEEW
WEWEEEEEEEEWKEEEEEWW
WEKWEEEEWWEEEEWEEEEW
WWEEWEEEEEEEEEWEWEEW
WEEEEEWEEEEEEEWWEEEW
WEWSEEEEEEEEEEWEWWEW
WKEKEWEEEEWEEEEEEEEW
WEWEEEEEEEEEEEKEEEEW
WEEEWEEWEEEEEDEEEEWW
WEEEEWEEEEEWEEEDEEEW
WWWWWWWWWWWWWWWWWWWW

WWWWWWWWWWWWWWWWWWWW
WEWEEEWEWEEWEEEEEEEW
WEWWEEEEWEEEEEWEEWWW
WEWEEEWEEEEEYWEEEWEW
WEWEYEEWEWWEEEEEWEEW
WEEEEYEWEEEWEEWEEEEW
WEWEWEEWEEEWEEEWWEEW
WEWEEWEWEWWWWEYEEGEW
WEEEEEWEEEEEYEEEWEEW
WWWEEEEEEEWWEEYEEEEW
WEWEEEEEEEEWYEEEEEWW
WEYWEEEEWWEEEEWEEEEW
WWEEWEEEEEEEEEWEWEEW
WEEEEEWEEEEEEEWWEEEW
WEWEEEEEEEEEEEWEWWEW
WYEYEWEEEEWEEEEEEEEW
WEWEEEEEEEEEEEYEEEEW
WEEEWEEWEEEEEYEEEEWW
WEEEEWEEEEEWEEEYEEEW
WWWWWWWWWWWWWWWWWWWW