WWWWWWWWWW
WWEEEWEEEW
WWWEEEEWWW
WWWWEEEWWW
WWWWEWEWEW
WWEEEWEGEW
WWWEEWEWWW
WEEEEWEEWW
WEEEEEWWWW
WWWWWWWWWW

WWWWWWWWWW
WWEEEWEEEW
WWWEEEEWWW
WWWWEEEWWW
WWWWEWEWEW
WWEEEWEGEW
WWWEEWEWWW
WEEEEWEEWW
WEEEEEWWWW
WWWWWWWWWW