WWWWWWWWWWWWWWWWWW
WEEEEWEWWEEEEEEEEW
WWKWWWEEWWEEWWKDEW
WWEWWWWEWEEDEWEWWW
WWKWWEWEEEWKEWEWWW
WWEEKEEWWWESEEEEEW
WWEEWDWWWEWEWEWWEW
WEWEEEWWKEEEEWWWWW
WEWWWEEDEEEWEWWEWW
WKWEEEWEEWWEEEWEWW
WDEEWEEWEDEWEEWEEW
WEEWWEWWWEWEWEKEEW
WWEWEEWEDEWEEWEEEW
WWEEEEEWEWEEEEEWWW
WEDEWEWKWEWEWKEEWW
WWWEEEEEEGEWEEWEEW
WWEEDEWWWWWWWEWWWW
WWWWWWWWWWWWWWWWWW

WWWWWWWWWWWWWWWWWW
WEEEEWEWWEEEEEEEEW
WWYWWWEEWWEEWWYYEW
WWEWWWWEWEEYEWEWWW
WWYWWEWEEEWYEWEWWW
WWEEYEEWWWEEEEEEEW
WWEEWYWWWEWEWEWWEW
WEWEEEWWYEEEEWWWWW
WEWWWEEYEEEWEWWEWW
WYWEEEWEEWWEEEWEWW
WYEEWEEWEYEWEEWEEW
WEEWWEWWWEWEWEYEEW
WWEWEEWEYEWEEWEEEW
WWEEEEEWEWEEEEEWWW
WEYEWEWYWEWEWYEEWW
WWWEEEEEEGEWEEWEEW
WWEEYEWWWWWWWEWWWW
WWWWWWWWWWWWWWWWWW