WWWWWWWWWWWWWWWWWW
WWWWWWWWWWWWWWWWWW
WWWWWWWWWWWWWWWWWW
WWWWWWWWWWWWWWWWWW
WWWWWWWWWWWWWWWWWW
WWWEWWWWWWWWWWWWWW
WEEEWWEWWWWWWWWWWW
WEEEEWEWWEWWWWWWWW
WWWEEEEEWEWWWWWWWW
WWEEGEEEEEEWWWWWWW
WWEEEEEEEEEEEWWWWW
WWWEEEEEEEEEEWWWWW
WWWEEEEWEEEEEEWWWW
WWWWEEEEEEEEWEWWWW
WWWWWWEEEEEEEEEWWW
WWWWWWWWEWEWEEEWWW
WWWWWWWWEEEWEEEWWW
WWWWWWWWWWWWWWWWWW

WWWWWWWWWWWWWWWWWW
WWWWWWWWWWWWWWWWWW
WWWWWWWWWWWWWWWWWW
WWWWWWWWWWWWWWWWWW
WWWWWWWWWWWWWWWWWW
WWWEWWWWWWWWWWWWWW
WEEEWWEWWWWWWWWWWW
WEEEEWEWWEWWWWWWWW
WWWEEEEEWEWWWWWWWW
WWEEGEEEEEEWWWWWWW
WWEEEEEEEEEEEWWWWW
WWWEEEEEEEEEEWWWWW
WWWEEEEWEEEEEEWWWW
WWWWEEEEEEEEWEWWWW
WWWWWWEEEEEEEEEWWW
WWWWWWWWEWEWEEEWWW
WWWWWWWWEEEWEEEWWW
WWWWWWWWWWWWWWWWWW