WWWWWWWWWWWW
WKEEEWEWWWWW
WWWEWWEEEWEW
WWWEEDEWEWKW
WWEEEWWEEEEW
WWWWEWKEWEEW
WWEWWWWWWWEW
WWEEEWEDEDEW
WWEWEEEGEWEW
WKEEEWEEWWWW
WSWWWWEWWWWW
WWWWWWWWWWWW

WWWWWWWWWWWW
WYEEEWEWWWWW
WWWEWWEEEWEW
WWWEEYEWEWYW
WWEEEWWEEEEW
WWWWEWYEWEEW
WWEWWWWWWWEW
WWEEEWEYEYEW
WWEWEEEGEWEW
WYEEEWEEWWWW
WEWWWWEWWWWW
WWWWWWWWWWWW