WWWWWWWWWW
WWEEEEEWWW
WEEEEEEEWW
WWWWEWWEWW
WEGEEEWWWW
WEEWWEEEEW
WWEEWEEEWW
WEEWEWWEWW
WEWEEEEEWW
WWWWWWWWWW

WWWWWWWWWW
WWEEEEEWWW
WEEEEEEEWW
WWWWEWWEWW
WEGEEEWWWW
WEEWWEEEEW
WWEEWEEEWW
WEEWEWWEWW
WEWEEEEEWW
WWWWWWWWWW