WWWWWWWWWWWWWWWWWWWW
WWWWWWWWWWWWWWWWWWWW
WWWWWWWWWWWWWWWWWWWW
WWWWWWWWWWWWWWWWWWWW
WEEWEEEWEDEEEEEWWWWW
WEEEEEEWEWEEEWEWWWWW
WDKEEKEKEWEEDWEEWWWW
WEEEKEEEEWWWWWWKEWWW
WEEEEDEEEWWWWWWWEWWW
WEKEEGEEEWWDSEEDEWWW
WDEEEEEEWWWEKEKEEWWW
WEEEEEKEEEWEKKWEEWWW
WWEEWEEEEKKEEWWEKEWW
WEEEKEWWWWWEEWWEWWWW
WEEEWEWWWWWEEWEEWWWW
WDEDWDDWWWWKEEEWWWWW
WEEEWEEWWWWWEEWWWWWW
WEEWKKWWWWWWWWWWWWWW
WEEWEEWWWWWWWWWWWWWW
WWWWWWWWWWWWWWWWWWWW

WWWWWWWWWWWWWWWWWWWW
WWWWWWWWWWWWWWWWWWWW
WWWWWWWWWWWWWWWWWWWW
WWWWWWWWWWWWWWWWWWWW
WEEWEEEWEYEEEEEWWWWW
WEEEEEEWEWEEEWEWWWWW
WYYEEYEYEWEEYWEEWWWW
WEEEYEEEEWWWWWWYEWWW
WEEEEYEEEWWWWWWWEWWW
WEYEEGEEEWWYEEEYEWWW
WYEEEEEEWWWEYEYEEWWW
WEEEEEYEEEWEYYWEEWWW
WWEEWEEEEYYEEWWEYEWW
WEEEYEWWWWWEEWWEWWWW
WEEEWEWWWWWEEWEEWWWW
WYEYWYYWWWWYEEEWWWWW
WEEEWEEWWWWWEEWWWWWW
WEEWYYWWWWWWWWWWWWWW
WEEWEEWWWWWWWWWWWWWW
WWWWWWWWWWWWWWWWWWWW