WWWWWWWWWWWWWWWWWW
WEEWEWWEEEEEEEEEEW
WEEEEWEEEWWGEEEEEW
WEEEEWWEWEEEEWEEEW
WEEEEEEEEEEWEWEWEW
WEWEEEEEEEWWWWWEEW
WEWEEEEEWWEEEWWDEW
WEEEEEEWEEEEEWEEWW
WEWWWDEEEEEDEEEEWW
WWEEEEWEEWEEEEWEEW
WWWEEEEEWEEEEWEEWW
WEKEKKEEWEEWEEWWEW
WEEEEEEEEWEWWWEEEW
WSEEWEEEEEEWWEEEEW
WKEEEWEEKEEEEEWWEW
WEEEWEWDEEEEEEWEEW
WWEEEEEEEEDEEEWEWW
WWWWWWWWWWWWWWWWWW

WWWWWWWWWWWWWWWWWW
WEEWEWWEEEEEEEEEEW
WEEEEWEEEWWGEEEEEW
WEEEEWWEWEEEEWEEEW
WEEEEEEEEEEWEWEWEW
WEWEEEEEEEWWWWWEEW
WEWEEEEEWWEEEWWYEW
WEEEEEEWEEEEEWEEWW
WEWWWYEEEEEYEEEEWW
WWEEEEWEEWEEEEWEEW
WWWEEEEEWEEEEWEEWW
WEYEYYEEWEEWEEWWEW
WEEEEEEEEWEWWWEEEW
WEEEWEEEEEEWWEEEEW
WYEEEWEEYEEEEEWWEW
WEEEWEWYEEEEEEWEEW
WWEEEEEEEEYEEEWEWW
WWWWWWWWWWWWWWWWWW