WWWWWWWWWWWWWWWWWW
WWWWWWEEEEEEEEEEEW
WWWWWEEEEEEWEEEEEW
WWWWWEWWWEEWEWEEEW
WWWEEEWEEEEEEEEEEW
WWWEEEWEEEEEEEEEEW
WWGEWWWEEEEEEEEWWW
WWWWWWWEEEEEEEEEEW
WWWWWWWWEEEEEEWWEW
WWWWWWWWEEEEEEEWEW
WWWWWWWWEEWWEEWWEW
WWWWWWWWEEWEEEWWWW
WWWWWWWWEEWEEEEEEW
WWWWWWWWWWWWEEEWEW
WWWWWWWWWWWWEEEWWW
WWWWWWWWWWWWEEWWWW
WWWWWWWWWWWWWWWWWW
WWWWWWWWWWWWWWWWWW

WWWWWWWWWWWWWWWWWW
WWWWWWEEEEEEEEEEEW
WWWWWEEEEEEWEEEEEW
WWWWWEWWWEEWEWEEEW
WWWEEEWEEEEEEEEEEW
WWWEEEWEEEEEEEEEEW
WWGEWWWEEEEEEEEWWW
WWWWWWWEEEEEEEEEEW
WWWWWWWWEEEEEEWWEW
WWWWWWWWEEEEEEEWEW
WWWWWWWWEEWWEEWWEW
WWWWWWWWEEWEEEWWWW
WWWWWWWWEEWEEEEEEW
WWWWWWWWWWWWEEEWEW
WWWWWWWWWWWWEEEWWW
WWWWWWWWWWWWEEWWWW
WWWWWWWWWWWWWWWWWW
WWWWWWWWWWWWWWWWWW