WWWWWWWWWWWWWWWWWWWW
WWWWWWWWWWWWWWWWWWWW
WWWWWWWWWWWWWWWWWWWW
WWWWWWWGEEWWWWWWWWWW
WWWWWWWEEEEEEWWWWWWW
WWWWWWWEEEEEEWWWWWWW
WWWWWWWEEEEEEWWWWWWW
WWWWWWEEWEEWEWWWWWWW
WWWWWWEEWWWWEWWWWWWW
WWWWWWWEWWWWEWEEWWWW
WWWWWWWEEWWWEEEEEWWW
WWWWWWWWEEEEEEEEEEEW
WWWWWWWWEEEEEEWWEWEW
WWWWWEEWEEEEEWWWEEEW
WWWWEEEEEEEEEWWWWWWW
WWWWEEEEEEEEEWWWWWEW
WWWWWWEWEEEEEEEEEEEW
WWWWEEEEWWEEEEWEEEEW
WWWWEEEEEEEEEEWEEEEW
WWWWWWWWWWWWWWWWWWWW

WWWWWWWWWWWWWWWWWWWW
WWWWWWWWWWWWWWWWWWWW
WWWWWWWWWWWWWWWWWWWW
WWWWWWWGEEWWWWWWWWWW
WWWWWWWEEEEEEWWWWWWW
WWWWWWWEEEEEEWWWWWWW
WWWWWWWEEEEEEWWWWWWW
WWWWWWEEWEEWEWWWWWWW
WWWWWWEEWWWWEWWWWWWW
WWWWWWWEWWWWEWEEWWWW
WWWWWWWEEWWWEEEEEWWW
WWWWWWWWEEEEEEEEEEEW
WWWWWWWWEEEEEEWWEWEW
WWWWWEEWEEEEEWWWEEEW
WWWWEEEEEEEEEWWWWWWW
WWWWEEEEEEEEEWWWWWEW
WWWWWWEWEEEEEEEEEEEW
WWWWEEEEWWEEEEWEEEEW
WWWWEEEEEEEEEEWEEEEW
WWWWWWWWWWWWWWWWWWWW