WWWWWWWWWWWWWWWWWWWW
WWEEWEEWEEEEWEEEWEEW
WEWEWEEEEWWEWWWEEEWW
WEWEWWEKWKEWEEEEEWDW
WEWEWEEEEEEEEEEEEWEW
WEEEEEKEEEEEWEEEEEEW
WEEEEWEEEEEEWEEEEEDW
WEWEWWEEEEWKEWEEEWEW
WWEWWDEWEWEEEWWEEWEW
WEEWWKEWWWEWEEEWEEEW
WEEEESEEEEEWWKEEWWWW
WEEEEEEWEWWWEEEEWEEW
WWEWEEEEEEEEEEEEEKEW
WEEEWWEEEEWEEEEEWWWW
WEEEEEEEWKEEWWEEWEEW
WEEEEEEEEEEWEWEEEEEW
WEWDEWEWEWEEEGEEWEEW
WEEEEWEDEEEEDWEEEEWW
WEEEEEEEEEWEEEWEEEEW
WWWWWWWWWWWWWWWWWWWW

WWWWWWWWWWWWWWWWWWWW
WWEEWEEWEEEEWEEEWEEW
WEWEWEEEEWWEWWWEEEWW
WEWEWWEYWYEWEEEEEWYW
WEWEWEEEEEEEEEEEEWEW
WEEEEEYEEEEEWEEEEEEW
WEEEEWEEEEEEWEEEEEYW
WEWEWWEEEEWYEWEEEWEW
WWEWWYEWEWEEEWWEEWEW
WEEWWYEWWWEWEEEWEEEW
WEEEEEEEEEEWWYEEWWWW
WEEEEEEWEWWWEEEEWEEW
WWEWEEEEEEEEEEEEEYEW
WEEEWWEEEEWEEEEEWWWW
WEEEEEEEWYEEWWEEWEEW
WEEEEEEEEEEWEWEEEEEW
WEWYEWEWEWEEEGEEWEEW
WEEEEWEYEEEEYWEEEEWW
WEEEEEEEEEWEEEWEEEEW
WWWWWWWWWWWWWWWWWWWW