WWWWWWWWWWWWWWWWWWWW
WWEWEWWEWEWWEEEEEEEW
WEEWEWEEEEEEEEWWWEEW
WEEWEEEEWEGEEEEEEWEW
WEEWEWEEWWEEWEEEEEWW
WEEEWEEEEEEEEWWEEWWW
WEEWWEWEEEEWWWWWEEEW
WEEEEEEEWEWEEEEWEEEW
WWEEEWEEEEWEEEWWWWEW
WEEWEEEEEEEEEEEEWEWW
WEEEEWEWEWEEEEEEEEWW
WWWWEWEEEEEWEEEWWEWW
WEWWEEEEWEEEEEEEWEWW
WEEWWWEEEEWEEWWEEWEW
WEEEWEEEEEEEEEWEWEEW
WEWEEWWEEEEEWEEWEEWW
WEEWEEEWEWWEEWEEEEEW
WEWEWEEEEEWEEEWEWWEW
WEEEEEWWEEEEEEEEEWEW
WWWWWWWWWWWWWWWWWWWW

WWWWWWWWWWWWWWWWWWWW
WWEWEWWEWEWWEEEEEEEW
WEEWEWEEEEEEEEWWWEEW
WEEWEEEEWEGEEEEEEWEW
WEEWEWEEWWEEWEEEEEWW
WEEEWEEEEEEEEWWEEWWW
WEEWWEWEEEEWWWWWEEEW
WEEEEEEEWEWEEEEWEEEW
WWEEEWEEEEWEEEWWWWEW
WEEWEEEEEEEEEEEEWEWW
WEEEEWEWEWEEEEEEEEWW
WWWWEWEEEEEWEEEWWEWW
WEWWEEEEWEEEEEEEWEWW
WEEWWWEEEEWEEWWEEWEW
WEEEWEEEEEEEEEWEWEEW
WEWEEWWEEEEEWEEWEEWW
WEEWEEEWEWWEEWEEEEEW
WEWEWEEEEEWEEEWEWWEW
WEEEEEWWEEEEEEEEEWEW
WWWWWWWWWWWWWWWWWWWW