WWWWWWWWWWWWWWWWWWWWWWWWWWWWWW
WEEEEEEEEWWWWWEEEEEEEWWWWWWWWW
WEEEEEEEEWWWWEEWEEWEEWWWWWWWWW
WEEWEEEEEWEEEEWWWWWEWWWWWWWWWW
WEEEEEEEEEEEEWWWEWWEWWWWWWWWWW
WEEEWEEEEEEEEWWWEEWEEEEEWWWWWW
WWWWWWEEEEEEEEWWEEWWEEWWWWWWWW
WWWWWWWWEEEEEEWWEEWWWWWWWWWWWW
WWWWEEWWWGEEEWWEEEWWWWWWWWWWWW
WEEWEEEEEEEEEEEEEEWWWWWWWWWWWW
WEEEEEEEEEEEEEEWEEWWWWWWWWWWWW
WEWEEEEEEEEEEEEEEEEWWWWWWWWWWW
WEEEEEEEEWEEEEEEEEEEWWWWWWWWWW
WEEEEEEEEWEEEEEEEEEEEWWWWWWWWW
WWWEEEEEEEEEWEEEEEWWEWWWWWWWWW
WWWWEEEEEEEEEWWWEEEEEWWWWWWWWW
WWWWEEEEEEEEEWWEEWWEEWWWWWWWWW
WWWWWWWWWWEEEEWEEWWEEEEWEEWWWW
WWWWWWWWWWEWWEEEEEWWWWEEEEWWWW
WWWWWWWWWWEWWEEEEEWWWWWEEEWWWW
WWWWWWWWWEEWWEEEEWWWWWWWWEWWWW
WWWWWWWWWEEWWWWWWWWWWWWWEEEEWW
WWWWWWWWWWEEWWWWWWWWWWWWEEEEEW
WWWWWWWWWWWEWWWWWWWWWWWWWWEEEW
WWWWWWWWWWEEWWWWWWWWWWWWWWWEEW
WWWWWWWWWWEEWWWWWWWWWWWWWWWWWW
WWWWWWWWWWWEWWWWWWWWWWWWWWWWWW
WWWWWWWWWEEEWWWWWWWWWWWWWWWWWW
WWWWWWWWWEEEEWWWWWWWWWWWWWWWWW
WWWWWWWWWWWWWWWWWWWWWWWWWWWWWW

WWWWWWWWWWWWWWWWWWWWWWWWWWWWWW
WEEEEEEEEWWWWWEEEEEEEWWWWWWWWW
WEEEEEEEEWWWWEEWEEWEEWWWWWWWWW
WEEWEEEEEWEEEEWWWWWEWWWWWWWWWW
WEEEEEEEEEEEEWWWEWWEWWWWWWWWWW
WEEEWEEEEEEEEWWWEEWEEEEEWWWWWW
WWWWWWEEEEEEEEWWEEWWEEWWWWWWWW
WWWWWWWWEEEEEEWWEEWWWWWWWWWWWW
WWWWEEWWWGEEEWWEEEWWWWWWWWWWWW
WEEWEEEEEEEEEEEEEEWWWWWWWWWWWW
WEEEEEEEEEEEEEEWEEWWWWWWWWWWWW
WEWEEEEEEEEEEEEEEEEWWWWWWWWWWW
WEEEEEEEEWEEEEEEEEEEWWWWWWWWWW
WEEEEEEEEWEEEEEEEEEEEWWWWWWWWW
WWWEEEEEEEEEWEEEEEWWEWWWWWWWWW
WWWWEEEEEEEEEWWWEEEEEWWWWWWWWW
WWWWEEEEEEEEEWWEEWWEEWWWWWWWWW
WWWWWWWWWWEEEEWEEWWEEEEWEEWWWW
WWWWWWWWWWEWWEEEEEWWWWEEEEWWWW
WWWWWWWWWWEWWEEEEEWWWWWEEEWWWW
WWWWWWWWWEEWWEEEEWWWWWWWWEWWWW
WWWWWWWWWEEWWWWWWWWWWWWWEEEEWW
WWWWWWWWWWEEWWWWWWWWWWWWEEEEEW
WWWWWWWWWWWEWWWWWWWWWWWWWWEEEW
WWWWWWWWWWEEWWWWWWWWWWWWWWWEEW
WWWWWWWWWWEEWWWWWWWWWWWWWWWWWW
WWWWWWWWWWWEWWWWWWWWWWWWWWWWWW
WWWWWWWWWEEEWWWWWWWWWWWWWWWWWW
WWWWWWWWWEEEEWWWWWWWWWWWWWWWWW
WWWWWWWWWWWWWWWWWWWWWWWWWWWWWW