WWWWWWWWWWWWWWWWWWWWWWWWWWWWWW
WEEEEEEEEWEEEWEEEEWEEEEEWEEEEW
WEEEEEEEEWWEEEEEEEEEEEEEEWWEEW
WEEEWEEEWEWEEEEEEEEEWWEWEEEEEW
WEEEWWEWEEEEEWEEEWEEEEEEEEEEEW
WEEWEEEEEEEEEEEWEEEEEEEWEEEEEW
WEEEEWEEEEEEEEEEEEEEEEEEEEWEEW
WWEEEEEEEEEEEEEEEEWEEWEEEEWEEW
WEWWEWEEEEEEEEEEEEEEWEEEEEEEEW
WEEEWEEEEEEEEEWEEEEEEEEEEEEEEW
WEEEEEEEEWEEEEEEEWEWEEEWEEWEEW
WEEEEEEEEEEEWEEWWEEEEEEEWEEWWW
WEEEEEEEEEEEEEEWEEEEEWEEEEEEEW
WWEEEEEWEEEEEEEEEEEEEEEEEWEEWW
WEEWEEEEEEEEWEEWEEEEWEWWEEEWEW
WEWEEEEEEEEEEWEEEEEEEEEEWEEEEW
WEEEEWEWEWEEEEEWEEEEEEEEWEEWEW
WEEEEGEEEEEEEEEEEEEEWEEWEEEEEW
WEEEEEEEWEWEEWEEEWWEEEEEEEEWEW
WEEEWEWEEEEEEWWEEEEWEEEEEEEEEW
WEEEWEEEEEEWWEEEEWWEEEEEEEEEEW
WWEEEEEEEEEWEWEEEEEEWEEWEWEEEW
WEEWEEEEWEEEEEEEEWWWEEEWEWEWEW
WEEEEWEEEEEEEWEEEEEEEEEEEEEEEW
WEEEEEEWEWWEEEEEWEEWEEEEEWWEWW
WEEWEEEEEEEEWEEEEEEWWEEEEEEEWW
WEEEEEEEEEEEEEEEEEEEEEEEEEEEWW
WWEEEEEEEEEWEEEWEEEEEEEEEEEEEW
WEEWEEEEEWEEEEEWEEEEEWEEWEWEEW
WWWWWWWWWWWWWWWWWWWWWWWWWWWWWW

WWWWWWWWWWWWWWWWWWWWWWWWWWWWWW
WEEEEEEEEWEEEWEEEEWEEEEEWEEEEW
WEEEEEEEEWWEEEEEEEEEEEEEEWWEEW
WEEEWEEEWEWEEEEEEEEEWWEWEEEEEW
WEEEWWEWEEEEEWEEEWEEEEEEEEEEEW
WEEWEEEEEEEEEEEWEEEEEEEWEEEEEW
WEEEEWEEEEEEEEEEEEEEEEEEEEWEEW
WWEEEEEEEEEEEEEEEEWEEWEEEEWEEW
WEWWEWEEEEEEEEEEEEEEWEEEEEEEEW
WEEEWEEEEEEEEEWEEEEEEEEEEEEEEW
WEEEEEEEEWEEEEEEEWEWEEEWEEWEEW
WEEEEEEEEEEEWEEWWEEEEEEEWEEWWW
WEEEEEEEEEEEEEEWEEEEEWEEEEEEEW
WWEEEEEWEEEEEEEEEEEEEEEEEWEEWW
WEEWEEEEEEEEWEEWEEEEWEWWEEEWEW
WEWEEEEEEEEEEWEEEEEEEEEEWEEEEW
WEEEEWEWEWEEEEEWEEEEEEEEWEEWEW
WEEEEGEEEEEEEEEEEEEEWEEWEEEEEW
WEEEEEEEWEWEEWEEEWWEEEEEEEEWEW
WEEEWEWEEEEEEWWEEEEWEEEEEEEEEW
WEEEWEEEEEEWWEEEEWWEEEEEEEEEEW
WWEEEEEEEEEWEWEEEEEEWEEWEWEEEW
WEEWEEEEWEEEEEEEEWWWEEEWEWEWEW
WEEEEWEEEEEEEWEEEEEEEEEEEEEEEW
WEEEEEEWEWWEEEEEWEEWEEEEEWWEWW
WEEWEEEEEEEEWEEEEEEWWEEEEEEEWW
WEEEEEEEEEEEEEEEEEEEEEEEEEEEWW
WWEEEEEEEEEWEEEWEEEEEEEEEEEEEW
WEEWEEEEEWEEEEEWEEEEEWEEWEWEEW
WWWWWWWWWWWWWWWWWWWWWWWWWWWWWW