WWWWWWWWWWWWWWW
WWEEWEEEEEWEEEW
WWEWWEEEEEEEWEW
WEEEWEEWWEEWWEW
WEWEEEEGEEEEEEW
WWEWEWEEEEEEWEW
WWEEEEEEEEEWWEW
WEWWEWEEEEEEEEW
WEEEEWEEWEEWWEW
WEEWWWWEWEEEEEW
WEEWWEEEWWEEWWW
WWEEEWWWEEEEEEW
WEEEEEEWWEEEEWW
WEWEWEEWEEEEEWW
WWWWWWWWWWWWWWW

WWWWWWWWWWWWWWW
WWEEWEEEEEWEEEW
WWEWWEEEEEEEWEW
WEEEWEEWWEEWWEW
WEWEEEEGEEEEEEW
WWEWEWEEEEEEWEW
WWEEEEEEEEEWWEW
WEWWEWEEEEEEEEW
WEEEEWEEWEEWWEW
WEEWWWWEWEEEEEW
WEEWWEEEWWEEWWW
WWEEEWWWEEEEEEW
WEEEEEEWWEEEEWW
WEWEWEEWEEEEEWW
WWWWWWWWWWWWWWW