WWWWWWWWWW
WWEEEEEEWW
WEWEWEEWWW
WEEEWEWWEW
WWEEWEWWEW
WEEEEEEEEW
WEWWEEEWEW
WEWWEWWEEW
WWWWWWEGWW
WWWWWWWWWW

WWWWWWWWWW
WWEEEEEEWW
WEWEWEEWWW
WEEEWEWWEW
WWEEWEWWEW
WEEEEEEEEW
WEWWEEEWEW
WEWWEWWEEW
WWWWWWEGWW
WWWWWWWWWW