WWWWWWWWWWWWWWWWWWWWWWWWWWWWWW
WWWWWWWWWWEEEEWWWWWWWWWWWWWWWW
WWWWWWWWWWEEWEEEWWWWWWWWWWWWWW
WWWWWWWWWWWWWWWEWWWWWWWWWWWWWW
WWWWWWWWWWWWWWWEWWWWWWWWWWWWWW
WWWWWWWWWWWWWWWEWWWWWWWWWWWWWW
WWWWWWWWWWWWWEEEEWWWWWWWWWWWWW
WWWWWWWWWWWWWEEEEWWWWWWWWWEEEW
WWWWWWWWWWWWWEEEEWWWWWEEEEEEEW
WWWWWWWWWWWWWEEEEEWWWWEEEEEEEW
WWWWWWWWWWWWWEEEEEEWWEEEEEEEEW
WWWWWWWWWWWWWWEEEEEEEEEEEEEEEW
WWWWWWWWWWWWWEEEEEEEEEEEEEEEEW
WWWWWWWWWWWWWEEEEEEEEEEEEEEEEW
WWWWWWWWWWWWWEEEEEEEEEEEWEEEEW
WWWWWWWWWWWWWWWWWEEEWEEEEEEEEW
WWWWWWWEEEEEEEEWWEEEWEEEEEEEEW
WWWWWWEEWWEEEEEEEEEEWEEEEEGEEW
WWWWEEEWWWWWEEWEEEEEWEEEEEEEEW
WWWWWWWWWWWEEEEEEEEEEEWWWEEEEW
WWWWWWWWWWWEEEEWEEEEEEWWWEEEEW
WWWWWWWWWWWEEEEEWWWWWEWWWWEEWW
WWWWWWWWWEEEEEEEWWWEEEWWWWWWWW
WWWWWWWWWEEEEEEWWWEEWWWWWWWWWW
WWWWWWWWWWWWEEEWWWEEWWWWWWWWWW
WWWWWWWWWWWWEEEWEEEEEWWWWWWWWW
WWWWWWWWWWWWEEEWWWEEEEWWWWWWWW
WWWWWWWWWWWWEEWEEEEEWEWWWWWWWW
WWWWWWWWWWWWWEEEEEEEEEWWWWWWWW
WWWWWWWWWWWWWWWWWWWWWWWWWWWWWW

WWWWWWWWWWWWWWWWWWWWWWWWWWWWWW
WWWWWWWWWWEEEEWWWWWWWWWWWWWWWW
WWWWWWWWWWEEWEEEWWWWWWWWWWWWWW
WWWWWWWWWWWWWWWEWWWWWWWWWWWWWW
WWWWWWWWWWWWWWWEWWWWWWWWWWWWWW
WWWWWWWWWWWWWWWEWWWWWWWWWWWWWW
WWWWWWWWWWWWWEEEEWWWWWWWWWWWWW
WWWWWWWWWWWWWEEEEWWWWWWWWWEEEW
WWWWWWWWWWWWWEEEEWWWWWEEEEEEEW
WWWWWWWWWWWWWEEEEEWWWWEEEEEEEW
WWWWWWWWWWWWWEEEEEEWWEEEEEEEEW
WWWWWWWWWWWWWWEEEEEEEEEEEEEEEW
WWWWWWWWWWWWWEEEEEEEEEEEEEEEEW
WWWWWWWWWWWWWEEEEEEEEEEEEEEEEW
WWWWWWWWWWWWWEEEEEEEEEEEWEEEEW
WWWWWWWWWWWWWWWWWEEEWEEEEEEEEW
WWWWWWWEEEEEEEEWWEEEWEEEEEEEEW
WWWWWWEEWWEEEEEEEEEEWEEEEEGEEW
WWWWEEEWWWWWEEWEEEEEWEEEEEEEEW
WWWWWWWWWWWEEEEEEEEEEEWWWEEEEW
WWWWWWWWWWWEEEEWEEEEEEWWWEEEEW
WWWWWWWWWWWEEEEEWWWWWEWWWWEEWW
WWWWWWWWWEEEEEEEWWWEEEWWWWWWWW
WWWWWWWWWEEEEEEWWWEEWWWWWWWWWW
WWWWWWWWWWWWEEEWWWEEWWWWWWWWWW
WWWWWWWWWWWWEEEWEEEEEWWWWWWWWW
WWWWWWWWWWWWEEEWWWEEEEWWWWWWWW
WWWWWWWWWWWWEEWEEEEEWEWWWWWWWW
WWWWWWWWWWWWWEEEEEEEEEWWWWWWWW
WWWWWWWWWWWWWWWWWWWWWWWWWWWWWW