WWWWWWWWWWWWWWWWWWWWWWWWWWWWWW
WWWWWWWWWWWWWWWWWWWWWWWWWWWWWW
WWWWWWWWWWWWEEWWWWWWWWWWWWWWWW
WWWWWWWWWWWEEEWWWWWWWWWWWWWWWW
WEEEWWWEEWWEEEWWWWWWWWWWWWWWWW
WEWEEEEEEEEEWWWWWWWWWWWWWWWWWW
WEEEEEEEWEEEWWWWWWWWWWWWWWWWWW
WEEEEEEEWEEEWWWWWWWWWWWWWWWWWW
WEEEEEEEWWWWWWWWWWWWWWWWWWWWWW
WEEEEEEEEWWWWWWWWWWWWWWWWWWWWW
WEEEWEEEEWWWWWWWWWWWWWWWWWWWWW
WEEEEEEEEWWWWWWWWWWWWWWWWWWWWW
WEEEEEEWEEEEEWWWWWWWWWWWWWWWWW
WEEEEEEEEEEEEEWWWWWWWWWWWWWWWW
WEEEWEEEWEEEEEWWWWWWWWWWWWWWWW
WEEEEEEEEEEEEEWWWWWWWWWWWWWWWW
WEEEEEEEEWWEEEWWWWWWWWWWWWWWWW
WGEEEEEEEWWWEEWWWWWWWWWWWWWWWW
WEEEEEEEEWWWEWWWWWWWWWWWWWWWWW
WEEEEWEEEEEEEWWWWWWWWWWWWWWWWW
WEEEWWEEEEEEEWWWWWWWWWWWWWWWWW
WEEEWWEEEEEEWWWWWWWWWWWWWWWWWW
WWWEEEEEEWWWWWWWWWWWWWWWWWWWWW
WWWWWWWWWWWWWWWWWWWWWWWWWWWWWW
WWWWWWWWWWWWWWWWWWWWWWWWWWWWWW
WWWWWWWWWWWWWWWWWWWWWWWWWWWWWW
WWWWWWWWWWWWWWWWWWWWWWWWWWWWWW
WWWWWWWWWWWWWWWWWWWWWWWWWWWWWW
WWWWWWWWWWWWWWWWWWWWWWWWWWWWWW
WWWWWWWWWWWWWWWWWWWWWWWWWWWWWW

WWWWWWWWWWWWWWWWWWWWWWWWWWWWWW
WWWWWWWWWWWWWWWWWWWWWWWWWWWWWW
WWWWWWWWWWWWEEWWWWWWWWWWWWWWWW
WWWWWWWWWWWEEEWWWWWWWWWWWWWWWW
WEEEWWWEEWWEEEWWWWWWWWWWWWWWWW
WEWEEEEEEEEEWWWWWWWWWWWWWWWWWW
WEEEEEEEWEEEWWWWWWWWWWWWWWWWWW
WEEEEEEEWEEEWWWWWWWWWWWWWWWWWW
WEEEEEEEWWWWWWWWWWWWWWWWWWWWWW
WEEEEEEEEWWWWWWWWWWWWWWWWWWWWW
WEEEWEEEEWWWWWWWWWWWWWWWWWWWWW
WEEEEEEEEWWWWWWWWWWWWWWWWWWWWW
WEEEEEEWEEEEEWWWWWWWWWWWWWWWWW
WEEEEEEEEEEEEEWWWWWWWWWWWWWWWW
WEEEWEEEWEEEEEWWWWWWWWWWWWWWWW
WEEEEEEEEEEEEEWWWWWWWWWWWWWWWW
WEEEEEEEEWWEEEWWWWWWWWWWWWWWWW
WGEEEEEEEWWWEEWWWWWWWWWWWWWWWW
WEEEEEEEEWWWEWWWWWWWWWWWWWWWWW
WEEEEWEEEEEEEWWWWWWWWWWWWWWWWW
WEEEWWEEEEEEEWWWWWWWWWWWWWWWWW
WEEEWWEEEEEEWWWWWWWWWWWWWWWWWW
WWWEEEEEEWWWWWWWWWWWWWWWWWWWWW
WWWWWWWWWWWWWWWWWWWWWWWWWWWWWW
WWWWWWWWWWWWWWWWWWWWWWWWWWWWWW
WWWWWWWWWWWWWWWWWWWWWWWWWWWWWW
WWWWWWWWWWWWWWWWWWWWWWWWWWWWWW
WWWWWWWWWWWWWWWWWWWWWWWWWWWWWW
WWWWWWWWWWWWWWWWWWWWWWWWWWWWWW
WWWWWWWWWWWWWWWWWWWWWWWWWWWWWW