WWWWWWWWWWWWWWWWWW
WEEWWKEEWEEEWEWWEW
WWEEEWEEEEWEDEKEEW
WEWEEWWWWEEEKWWEEW
WEEEEEEEWDEEEEEEWW
WEWEWEEEEEWEEEEEWW
WDEEWWEEWWEEEEEWEW
WEWWEEEEEEWEWEWEKW
WEEKEEWEEEWEKEEEEW
WEEWEWWEWEEWEWWEEW
WWEEEEEEEEEEWEEWEW
WWEWEWEWGWWWWWEEEW
WWEEWEWWEWWEDEEWEW
WEEWEEWEEEWEWWEEWW
WKEWEEWWWWEEEWEEEW
WEEWDEESKEWEEEWWEW
WWWEEEEEWEDEEWEEEW
WWWWWWWWWWWWWWWWWW

WWWWWWWWWWWWWWWWWW
WEEWWYEEWEEEWEWWEW
WWEEEWEEEEWEYEYEEW
WEWEEWWWWEEEYWWEEW
WEEEEEEEWYEEEEEEWW
WEWEWEEEEEWEEEEEWW
WYEEWWEEWWEEEEEWEW
WEWWEEEEEEWEWEWEYW
WEEYEEWEEEWEYEEEEW
WEEWEWWEWEEWEWWEEW
WWEEEEEEEEEEWEEWEW
WWEWEWEWGWWWWWEEEW
WWEEWEWWEWWEYEEWEW
WEEWEEWEEEWEWWEEWW
WYEWEEWWWWEEEWEEEW
WEEWYEEEYEWEEEWWEW
WWWEEEEEWEYEEWEEEW
WWWWWWWWWWWWWWWWWW