WWWWWWWWWWWWWWWWWWWW
WEEEEEWWEEEEWEEEWEEW
WEEEEEWEWEEEEEEEEEEW
WEEEEEWEEEEEEEEEEEEW
WWEEEWEEEEEWEEEKEEWW
WEEWEEEEEEEEEEWEEEWW
WEEEEEEWEEKEWEEEWEEW
WEEEEEEEEEWEEEEEEWEW
WEEEWEEEWEEEEEEEEESW
WEEEKEEEEEDWWEEWEEKW
WEEEWWEEEWEEEEEEEEEW
WWEWEEEEEEEEEEEEWEEW
WWEEDEEWEWWWEEWEEEEW
WEEEEEEEEEEEKEEEEEEW
WWEGEEWWEEEWEEEEEEEW
WEEEEWEDEEEWEEEEWEEW
WEEEEEEEEEEEEEWEEEEW
WWEEEEEWEKEEEEEEEEEW
WEEEEEEEEEWWEEEEEEEW
WWWWWWWWWWWWWWWWWWWW

WWWWWWWWWWWWWWWWWWWW
WEEEEEWWEEEEWEEEWEEW
WEEEEEWEWEEEEEEEEEEW
WEEEEEWEEEEEEEEEEEEW
WWEEEWEEEEEWEEEYEEWW
WEEWEEEEEEEEEEWEEEWW
WEEEEEEWEEYEWEEEWEEW
WEEEEEEEEEWEEEEEEWEW
WEEEWEEEWEEEEEEEEEEW
WEEEYEEEEEYWWEEWEEYW
WEEEWWEEEWEEEEEEEEEW
WWEWEEEEEEEEEEEEWEEW
WWEEYEEWEWWWEEWEEEEW
WEEEEEEEEEEEYEEEEEEW
WWEGEEWWEEEWEEEEEEEW
WEEEEWEYEEEWEEEEWEEW
WEEEEEEEEEEEEEWEEEEW
WWEEEEEWEYEEEEEEEEEW
WEEEEEEEEEWWEEEEEEEW
WWWWWWWWWWWWWWWWWWWW