WWWWWWWWWWWWWWWWWW
WWWWWWWWWWWWWWWWWW
WWWWWWWWWWWWWWWWWW
WWWWWWWWEEEEWWWWWW
WWEEWWGEEWWWWWWWWW
WWWEEEEEEEWWWWWWWW
WWWWWEEEEEEWWWWWWW
WWWWWWEEEEEWWWWWWW
WWWWEWEEEEWWWWWWWW
WWWWEEEEEEEWWWWEWW
WWWWWEEEEEEWWWWEEW
WWWWWWEEEEEWWWEEEW
WWWWWWEEEEEEWWEEEW
WWWWWWWEEEEEEEEEEW
WWWWWWEEEEWWEEEEEW
WWWWWWEEEWWWEEEEEW
WWWWWWEEEWWWWEEEEW
WWWWWWWWWWWWWWWWWW

WWWWWWWWWWWWWWWWWW
WWWWWWWWWWWWWWWWWW
WWWWWWWWWWWWWWWWWW
WWWWWWWWEEEEWWWWWW
WWEEWWGEEWWWWWWWWW
WWWEEEEEEEWWWWWWWW
WWWWWEEEEEEWWWWWWW
WWWWWWEEEEEWWWWWWW
WWWWEWEEEEWWWWWWWW
WWWWEEEEEEEWWWWEWW
WWWWWEEEEEEWWWWEEW
WWWWWWEEEEEWWWEEEW
WWWWWWEEEEEEWWEEEW
WWWWWWWEEEEEEEEEEW
WWWWWWEEEEWWEEEEEW
WWWWWWEEEWWWEEEEEW
WWWWWWEEEWWWWEEEEW
WWWWWWWWWWWWWWWWWW