WWWWWWWWWWWWWWWWWWWW
WWEEEWEGWEEEWEEWKEWW
WWEEEWEDDWEEEEEEEWWW
WWWWDWEWWEWEEEEWWWEW
WWWEEEEWWEWEEEWWWEEW
WWEWWWEKEEEEEEEWEEWW
WEEEEWEKWEWEWEEEEEEW
WWEWEWWEDDWWWWEDWEWW
WEEWWWWWEWDEEEEEKEEW
WWEEWWEWEWEWEEEWWWEW
WEEEEWEEEEWEKWEEWEWW
WEWWEEEEEDWWEEEWEEEW
WWKKEWEEDEDEWEWEWEEW
WEEEEEKEWWDWWEEEEEEW
WWDEEWEEEWEEWKWEEWEW
WWEWEEEWWWEEWEEEEEWW
WWWEEEEWEDEEEEWEWEEW
WWWWWEEEEEEEWEKEWWEW
WEEEEEEEWEEWWDEEWEEW
WWWWWWWWWWWWWWWWWWWW

WWWWWWWWWWWWWWWWWWWW
WWEEEWEGWEEEWEEWYEWW
WWEEEWEYYWEEEEEEEWWW
WWWWYWEWWEWEEEEWWWEW
WWWEEEEWWEWEEEWWWEEW
WWEWWWEYEEEEEEEWEEWW
WEEEEWEYWEWEWEEEEEEW
WWEWEWWEYYWWWWEYWEWW
WEEWWWWWEWYEEEEEYEEW
WWEEWWEWEWEWEEEWWWEW
WEEEEWEEEEWEYWEEWEWW
WEWWEEEEEYWWEEEWEEEW
WWYYEWEEYEYEWEWEWEEW
WEEEEEYEWWYWWEEEEEEW
WWYEEWEEEWEEWYWEEWEW
WWEWEEEWWWEEWEEEEEWW
WWWEEEEWEYEEEEWEWEEW
WWWWWEEEEEEEWEYEWWEW
WEEEEEEEWEEWWYEEWEEW
WWWWWWWWWWWWWWWWWWWW