WWWWWWWWWW
WEEEWWEEEW
WWEEWEEWEW
WWEEEEEEEW
WEEEGEEWEW
WEEWWWEEEW
WWEEEWEEWW
WEEEWEEEEW
WEEWWEEEWW
WWWWWWWWWW

WWWWWWWWWW
WEEEWWEEEW
WWEEWEEWEW
WWEEEEEEEW
WEEEGEEWEW
WEEWWWEEEW
WWEEEWEEWW
WEEEWEEEEW
WEEWWEEEWW
WWWWWWWWWW