WWWWWWWWWWWWWWW
WKWEEEEWWEEEEEW
WSEEEEEEEEEWEEW
WEEEEEEEEDEEEWW
WEKEWEEEEEEEEEW
WWEEEEEEEEGEEEW
WEEWWEEEEEEEEEW
WEEEEWEWWEWEEEW
WEEEEEWWEEEEEWW
WDEWEEEEEEWEEEW
WEEEEWEEEWEEEEW
WEEEEEEEEWEWEEW
WEEEEEEWEEWEEEW
WEEEEEEEEEEEEEW
WWWWWWWWWWWWWWW

WWWWWWWWWWWWWWW
WYWEEEEWWEEEEEW
WEEEEEEEEEEWEEW
WEEEEEEEEYEEEWW
WEYEWEEEEEEEEEW
WWEEEEEEEEGEEEW
WEEWWEEEEEEEEEW
WEEEEWEWWEWEEEW
WEEEEEWWEEEEEWW
WYEWEEEEEEWEEEW
WEEEEWEEEWEEEEW
WEEEEEEEEWEWEEW
WEEEEEEWEEWEEEW
WEEEEEEEEEEEEEW
WWWWWWWWWWWWWWW