WWWWWWWWWWWWWWW
WEEEEEEEEEEEEEW
WWEEWEEEEEWEWWW
WWEEWWEEWEWEWWW
WEEWGWEWWEEWEEW
WEWEEEEWWWEEEEW
WEWEWEEWEEEEEEW
WEEEEEEWEEWEWWW
WEEEWEEWWEWEEWW
WEEWWEWEWEEWEEW
WEEEWEEEWEEEEWW
WEWEWWWEEWEEEEW
WEWEWEEEEEWEWWW
WWWWEEWWWEEEWWW
WWWWWWWWWWWWWWW

WWWWWWWWWWWWWWW
WEEEEEEEEEEEEEW
WWEEWEEEEEWEWWW
WWEEWWEEWEWEWWW
WEEWGWEWWEEWEEW
WEWEEEEWWWEEEEW
WEWEWEEWEEEEEEW
WEEEEEEWEEWEWWW
WEEEWEEWWEWEEWW
WEEWWEWEWEEWEEW
WEEEWEEEWEEEEWW
WEWEWWWEEWEEEEW
WEWEWEEEEEWEWWW
WWWWEEWWWEEEWWW
WWWWWWWWWWWWWWW