WWWWWWWWWWWWWWWWWWWW
WEWEEWEEEEGEEEEEEEWW
WEEEEEEEEWEEEWEEEEEW
WEWEEEEEEWWEEWEEEEEW
WEEWEEEEWWEEWWWEEWEW
WEWEEWEEEEEEEEEWEEEW
WEEWEEEEWEEWEEEEEEEW
WEWWEEEEEEWEEWEEEWEW
WEEEEEEEWWEEWEEEEWEW
WEEEEEWWEEWEWEWWEEEW
WEEWWEEWEEEEWEEEWWEW
WEEWEEEWEEEWEWEEWEEW
WEEWWEEWEEEEEWEEWEEW
WEEEEEEEEEEEEWEEEEWW
WWWEWEWEEEWEWEEEWEEW
WWWEEEEEEWEWEEEEEEWW
WWWEEEWEWEEEEWWWWWEW
WEEEEEWEEEEEWEEEWEEW
WEEEEEEEEWWEEEWEEEWW
WWWWWWWWWWWWWWWWWWWW

WWWWWWWWWWWWWWWWWWWW
WEWEEWEEEEGEEEEEEEWW
WEEEEEEEEWEEEWEEEEEW
WEWEEEEEEWWEEWEEEEEW
WEEWEEEEWWEEWWWEEWEW
WEWEEWEEEEEEEEEWEEEW
WEEWEEEEWEEWEEEEEEEW
WEWWEEEEEEWEEWEEEWEW
WEEEEEEEWWEEWEEEEWEW
WEEEEEWWEEWEWEWWEEEW
WEEWWEEWEEEEWEEEWWEW
WEEWEEEWEEEWEWEEWEEW
WEEWWEEWEEEEEWEEWEEW
WEEEEEEEEEEEEWEEEEWW
WWWEWEWEEEWEWEEEWEEW
WWWEEEEEEWEWEEEEEEWW
WWWEEEWEWEEEEWWWWWEW
WEEEEEWEEEEEWEEEWEEW
WEEEEEEEEWWEEEWEEEWW
WWWWWWWWWWWWWWWWWWWW