WWWWWWWWWWWWWWWWWWWW
WEEWEEWKWEEEEWEWEWEW
WEEEWEEEWDWWEEEWEEEW
WWEEEWEWWEKEEWDWWEEW
WEDEEEEWEEEEEEEEEEEW
WDWEEDEWWEEWEEWEWEWW
WWWEEEEEWEEEEWEKEEEW
WWEEWEWEEEEEWEEEEWEW
WEWESEWEEEWWEWEEEWEW
WEKEKWEEEWEEEEKEEWWW
WEEWEEWEEEEWWEEEEWWW
WEEEEEEEEEEEEWWEWWWW
WEEKEEWEEWEEEDWEWKEW
WWEEEWWEEWKEEEEEEDEW
WWEEEWEEEEEEEEWWEEWW
WWEEEEEEWEWWEEEEEKEW
WEWWEEWEEEEEEWEEEEWW
WEEEEEEWEWEEEEEWWEEW
WWWKWEWWGEEWEEEWEEEW
WWWWWWWWWWWWWWWWWWWW

WWWWWWWWWWWWWWWWWWWW
WEEWEEWYWEEEEWEWEWEW
WEEEWEEEWYWWEEEWEEEW
WWEEEWEWWEYEEWYWWEEW
WEYEEEEWEEEEEEEEEEEW
WYWEEYEWWEEWEEWEWEWW
WWWEEEEEWEEEEWEYEEEW
WWEEWEWEEEEEWEEEEWEW
WEWEEEWEEEWWEWEEEWEW
WEYEYWEEEWEEEEYEEWWW
WEEWEEWEEEEWWEEEEWWW
WEEEEEEEEEEEEWWEWWWW
WEEYEEWEEWEEEYWEWYEW
WWEEEWWEEWYEEEEEEYEW
WWEEEWEEEEEEEEWWEEWW
WWEEEEEEWEWWEEEEEYEW
WEWWEEWEEEEEEWEEEEWW
WEEEEEEWEWEEEEEWWEEW
WWWYWEWWGEEWEEEWEEEW
WWWWWWWWWWWWWWWWWWWW