WWWWWWWWWWWWWWWWWWWWWWWWWWWWWW
WWWWWWWWWWWWWWWWWWWWWWWWWWWWWW
WWWWWWWWWWWWWWWWWWWWWWWWEWWWWW
WWWWWWWWWWWWWWWWWWWWWWWWEWWWWW
WWWWWWWWWWWWWWWWWWWWWWWWEEWWWW
WWWWWWWWWWWWWWWWWWWWWWWWWEWWWW
WWWWWWWWWWWWWWWWWWWWWWWWWEEWWW
WWWWWWWWWWWWWWWWWWWWWWWWEEEWWW
WWWWWWWWWWWWWWWWWWWWWWWEEEEWWW
WEEWEEWWWWWWWWWWWWWWWWWEEEWWWW
WEEEEEWWWWWWWWWWWWWWWWWEEEWWWW
WWEEEEWWWWWWWWWWWWWWWWWEWWWWWW
WWEWEEWWWWWWWWWWWWWWWWWEWWWWWW
WEEWWWWWWWWWWWWWWWWWWWWEWWWWWW
WEWWWWWWWWWWWWWWWWWWWWEEWWWWWW
WEEEEEEWWWWWWWWWWWWWWEEWWWWWWW
WWWWWWEEEEWWWWWWWWWWEEWWWWWWWW
WWWWWWEEEWWWWWWWWEEWEEEEWWWWWW
WWWWWWEWWWWWWWWWWWEWEWEEWWWWWW
WWWWWWEWWWWWWWWWWWEEEWEEEEEWWW
WWWWWWEEEEEWWWWWWWWEEEEWWWEWWW
WWWWWWEEEEEEWWWWWEEEEEEEEEEWWW
WWEEEEEEEEEEEEEEEEWWWWEWWWWWWW
WWEEEEEEEEEWWEEWWWWWWWEEEWWWWW
WWEEEEEEEEEWEEEWWWWWWWWWWWWWWW
WEEEEEEEEEEEEWWWWWWWWWWWWWWWWW
WEEEEEEEEEEEEWWWWWWWWWWWWWWWWW
WEEEEEEWEEEWWWWWWWWWWWWWWWWWWW
WEEEEGEWWWWWWWWWWWWWWWWWWWWWWW
WWWWWWWWWWWWWWWWWWWWWWWWWWWWWW

WWWWWWWWWWWWWWWWWWWWWWWWWWWWWW
WWWWWWWWWWWWWWWWWWWWWWWWWWWWWW
WWWWWWWWWWWWWWWWWWWWWWWWEWWWWW
WWWWWWWWWWWWWWWWWWWWWWWWEWWWWW
WWWWWWWWWWWWWWWWWWWWWWWWEEWWWW
WWWWWWWWWWWWWWWWWWWWWWWWWEWWWW
WWWWWWWWWWWWWWWWWWWWWWWWWEEWWW
WWWWWWWWWWWWWWWWWWWWWWWWEEEWWW
WWWWWWWWWWWWWWWWWWWWWWWEEEEWWW
WEEWEEWWWWWWWWWWWWWWWWWEEEWWWW
WEEEEEWWWWWWWWWWWWWWWWWEEEWWWW
WWEEEEWWWWWWWWWWWWWWWWWEWWWWWW
WWEWEEWWWWWWWWWWWWWWWWWEWWWWWW
WEEWWWWWWWWWWWWWWWWWWWWEWWWWWW
WEWWWWWWWWWWWWWWWWWWWWEEWWWWWW
WEEEEEEWWWWWWWWWWWWWWEEWWWWWWW
WWWWWWEEEEWWWWWWWWWWEEWWWWWWWW
WWWWWWEEEWWWWWWWWEEWEEEEWWWWWW
WWWWWWEWWWWWWWWWWWEWEWEEWWWWWW
WWWWWWEWWWWWWWWWWWEEEWEEEEEWWW
WWWWWWEEEEEWWWWWWWWEEEEWWWEWWW
WWWWWWEEEEEEWWWWWEEEEEEEEEEWWW
WWEEEEEEEEEEEEEEEEWWWWEWWWWWWW
WWEEEEEEEEEWWEEWWWWWWWEEEWWWWW
WWEEEEEEEEEWEEEWWWWWWWWWWWWWWW
WEEEEEEEEEEEEWWWWWWWWWWWWWWWWW
WEEEEEEEEEEEEWWWWWWWWWWWWWWWWW
WEEEEEEWEEEWWWWWWWWWWWWWWWWWWW
WEEEEGEWWWWWWWWWWWWWWWWWWWWWWW
WWWWWWWWWWWWWWWWWWWWWWWWWWWWWW