WWWWWWWWWWWWWWWWWWWWWWWWWWWWWW
WWEWEEWEWEEWEEEEEEWEEEEWWEWEEW
WWEEEEWEEEEEEEEWEEEEEEEWEEEEWW
WWWEWWEWEEEEEEEWWEEEEEEEWWWEEW
WEEEEEEWEEWEWWWEWEWEWWWGEEEEEW
WEEEEEEWEEEWEEEEWEEEEWEWEEWEEW
WEEEEEEEEEEEEEWEEEWEWEEEWEEWWW
WEWEEEEEEWEEWEEEWEEEWWEEWEEEEW
WEWWEEEWEEEEEEEWEEEEWEEWEEEEWW
WEEEEWEEEEWEWWWEEEEWEWEEEWWWEW
WWWWEEEEWEWEWEEEEEEEEEEEWEEEEW
WWEEWWEWWEEEWEEEWEWEWEEEEEEWWW
WWEEEWEEEEEEWWWEEWWEEEEEEEWEEW
WEEEEEEEWEWEEEEEEEEEEWEEEEWEWW
WEEWWEEEEEEWEWEEEEWEEEEEEEEEEW
WEEWWEEEWWEWEEEEEEEEWWWWEEEEEW
WEEEEEEEEEWEEWWEEEEEEEWWEEEWEW
WEEEEEWEWEEEEWWWEWEEEWEWEEEEEW
WEWEEEEWEEEEEEEEWWEEEWEEEEEEEW
WWWWEWEEWEWWWEEEEEEEWWEEEEEEWW
WEEWEEEEEEEEEWWEWEEEEWWEWWEEEW
WEWWEWEEEEEEEEEWEWEWEWEEWEEEWW
WEEEWWEEEEWEEWEWEEEEWWWEEEEEWW
WWEEWEEEWWWWWEEEEEWEWEWEWEWEWW
WEEEEWEEWEEEEEEWEEEEEEEWEWEEEW
WEEWEEEEEWEEEWEEEEEWWWWWEEEEEW
WEEEEEWEEEEEEEWWWEEEWWEWEWEEEW
WEEEEEWWEEEEWEEWEWEWWEEWEWEWEW
WWWEWEWEEWEEEEEEEEEEWEEEEEEEEW
WWWWWWWWWWWWWWWWWWWWWWWWWWWWWW

WWWWWWWWWWWWWWWWWWWWWWWWWWWWWW
WWEWEEWEWEEWEEEEEEWEEEEWWEWEEW
WWEEEEWEEEEEEEEWEEEEEEEWEEEEWW
WWWEWWEWEEEEEEEWWEEEEEEEWWWEEW
WEEEEEEWEEWEWWWEWEWEWWWGEEEEEW
WEEEEEEWEEEWEEEEWEEEEWEWEEWEEW
WEEEEEEEEEEEEEWEEEWEWEEEWEEWWW
WEWEEEEEEWEEWEEEWEEEWWEEWEEEEW
WEWWEEEWEEEEEEEWEEEEWEEWEEEEWW
WEEEEWEEEEWEWWWEEEEWEWEEEWWWEW
WWWWEEEEWEWEWEEEEEEEEEEEWEEEEW
WWEEWWEWWEEEWEEEWEWEWEEEEEEWWW
WWEEEWEEEEEEWWWEEWWEEEEEEEWEEW
WEEEEEEEWEWEEEEEEEEEEWEEEEWEWW
WEEWWEEEEEEWEWEEEEWEEEEEEEEEEW
WEEWWEEEWWEWEEEEEEEEWWWWEEEEEW
WEEEEEEEEEWEEWWEEEEEEEWWEEEWEW
WEEEEEWEWEEEEWWWEWEEEWEWEEEEEW
WEWEEEEWEEEEEEEEWWEEEWEEEEEEEW
WWWWEWEEWEWWWEEEEEEEWWEEEEEEWW
WEEWEEEEEEEEEWWEWEEEEWWEWWEEEW
WEWWEWEEEEEEEEEWEWEWEWEEWEEEWW
WEEEWWEEEEWEEWEWEEEEWWWEEEEEWW
WWEEWEEEWWWWWEEEEEWEWEWEWEWEWW
WEEEEWEEWEEEEEEWEEEEEEEWEWEEEW
WEEWEEEEEWEEEWEEEEEWWWWWEEEEEW
WEEEEEWEEEEEEEWWWEEEWWEWEWEEEW
WEEEEEWWEEEEWEEWEWEWWEEWEWEWEW
WWWEWEWEEWEEEEEEEEEEWEEEEEEEEW
WWWWWWWWWWWWWWWWWWWWWWWWWWWWWW