WWWWWWWWWWWWWWWWWWWWWWWWWWWWWW
WEWEWEEEEWEEEEEEWEEEEWWEEWEEEW
WEWEEWEEEEEEEWEEEEEEEEEWEWEWEW
WEEEEEEEEWWEEEEEEWEEEEEEEEEEEW
WEEEWEEWEEWEEEEWEEEEEEEEEEEEEW
WEEEEEEWWWEEEWEEEEEEWEEEEEEEWW
WWWEEEEEEEEEWEEEEEEWEEEEEEEEEW
WEEEEEEEEWEEEEEEWEEWEEEEEEEEEW
WEEEEEEEEEEEWEEEEEEWWEEEWWEEWW
WEEEEEEEEWEWEWEEEWEEEEEEEEWWWW
WEWEEEEEEEEEEEEEWWEWEWEEEEEWEW
WEEEEEEEEEWEEEEEWEEWEEEEEEEWEW
WEEWEEEEEEEEEEWEEWEEEWEEEEEEEW
WEEEEEEEWEEEEWWEEEEEEEEEWEEWEW
WWEWEEEEEEEWEWWWEWEWEEEEEEEEWW
WEEEEEEWEEEWEEEEEEEEWEEEWEEEEW
WEEWEEEEWEEEEEEEWEWEEWEEEWEEEW
WEEWEEEWEEWEWWWEWEEEEEEWEEEEWW
WEEEWEEWWEEWEEWEEEEEWEEEEEEEEW
WEEEEEEEEWEWEEEEEWWEEEEEEEEEEW
WEEWEWEEEEEEEEEWEEEWEEEWEEEEEW
WEEGEEEEEEEEWWEEEEEEEEWEEEEEEW
WEEWEEWWEEEEEEEEEEEEEEEEEEEEEW
WEEEEEWEEWEEEWEEWEEEEEEEEEEEEW
WWEEEEEWEEEEEEEEEEWWEEWWEEWEEW
WWEEEEEEWEWEEEWEEEEEWEEWEEEEEW
WEEEEEEEEEEEEEEEEEEWEEEEEEEEEW
WEEEEWWEEEEWEEEEEEEEEWEWEEEEEW
WEEEEEEWEEEEEEEEEEEWWEEEEEEEEW
WWWWWWWWWWWWWWWWWWWWWWWWWWWWWW

WWWWWWWWWWWWWWWWWWWWWWWWWWWWWW
WEWEWEEEEWEEEEEEWEEEEWWEEWEEEW
WEWEEWEEEEEEEWEEEEEEEEEWEWEWEW
WEEEEEEEEWWEEEEEEWEEEEEEEEEEEW
WEEEWEEWEEWEEEEWEEEEEEEEEEEEEW
WEEEEEEWWWEEEWEEEEEEWEEEEEEEWW
WWWEEEEEEEEEWEEEEEEWEEEEEEEEEW
WEEEEEEEEWEEEEEEWEEWEEEEEEEEEW
WEEEEEEEEEEEWEEEEEEWWEEEWWEEWW
WEEEEEEEEWEWEWEEEWEEEEEEEEWWWW
WEWEEEEEEEEEEEEEWWEWEWEEEEEWEW
WEEEEEEEEEWEEEEEWEEWEEEEEEEWEW
WEEWEEEEEEEEEEWEEWEEEWEEEEEEEW
WEEEEEEEWEEEEWWEEEEEEEEEWEEWEW
WWEWEEEEEEEWEWWWEWEWEEEEEEEEWW
WEEEEEEWEEEWEEEEEEEEWEEEWEEEEW
WEEWEEEEWEEEEEEEWEWEEWEEEWEEEW
WEEWEEEWEEWEWWWEWEEEEEEWEEEEWW
WEEEWEEWWEEWEEWEEEEEWEEEEEEEEW
WEEEEEEEEWEWEEEEEWWEEEEEEEEEEW
WEEWEWEEEEEEEEEWEEEWEEEWEEEEEW
WEEGEEEEEEEEWWEEEEEEEEWEEEEEEW
WEEWEEWWEEEEEEEEEEEEEEEEEEEEEW
WEEEEEWEEWEEEWEEWEEEEEEEEEEEEW
WWEEEEEWEEEEEEEEEEWWEEWWEEWEEW
WWEEEEEEWEWEEEWEEEEEWEEWEEEEEW
WEEEEEEEEEEEEEEEEEEWEEEEEEEEEW
WEEEEWWEEEEWEEEEEEEEEWEWEEEEEW
WEEEEEEWEEEEEEEEEEEWWEEEEEEEEW
WWWWWWWWWWWWWWWWWWWWWWWWWWWWWW