WWWWWWWWWWWWWWWWWWWW
WEEEEEEEEEEEEEEEEEEW
WEEEEEEEWEEEEEEEEEEW
WEEEWEEWEEEEEEWEEEEW
WEEEEWEEEWEEWEEEEEWW
WEEEEEWEEEEEWEWEWEWW
WWEEEEEEWEEEWEEEEWEW
WEEEEEEWEEEWGEEEEWEW
WEEEEEEWEWWEEEEEEEEW
WWWWEEWEEEEEEEWEEWEW
WEEWWEEEEEEEEEEWEEEW
WEEEWEWEEEEWEWEEEEEW
WEWEEEEEWEWEEEEWEWEW
WEEEEEEEEEEEEEEWEEEW
WEEEEEEWEEEEEEEEEEWW
WEEWEEEWWEEEEEEEEEEW
WEEEEEEEWWEEEEEEEEEW
WEEEWEWEWEEEEWWEEEEW
WWEEEEEEEEWWEEEEEEEW
WWWWWWWWWWWWWWWWWWWW

WWWWWWWWWWWWWWWWWWWW
WEEEEEEEEEEEEEEEEEEW
WEEEEEEEWEEEEEEEEEEW
WEEEWEEWEEEEEEWEEEEW
WEEEEWEEEWEEWEEEEEWW
WEEEEEWEEEEEWEWEWEWW
WWEEEEEEWEEEWEEEEWEW
WEEEEEEWEEEWGEEEEWEW
WEEEEEEWEWWEEEEEEEEW
WWWWEEWEEEEEEEWEEWEW
WEEWWEEEEEEEEEEWEEEW
WEEEWEWEEEEWEWEEEEEW
WEWEEEEEWEWEEEEWEWEW
WEEEEEEEEEEEEEEWEEEW
WEEEEEEWEEEEEEEEEEWW
WEEWEEEWWEEEEEEEEEEW
WEEEEEEEWWEEEEEEEEEW
WEEEWEWEWEEEEWWEEEEW
WWEEEEEEEEWWEEEEEEEW
WWWWWWWWWWWWWWWWWWWW