WWWWWWWWWWWW
WEWWEKEWWWWW
WEEEWWEWWWWW
WWDEWEEEEEEW
WWWEWWWWWEWW
WEEEEEWWWEWW
WEEWWSWEEEEW
WWWEWKWEEWEW
WWKEGKWWKWWW
WEEWWEDEEEWW
WDWWWWEEWEWW
WWWWWWWWWWWW

WWWWWWWWWWWW
WEWWEYEWWWWW
WEEEWWEWWWWW
WWYEWEEEEEEW
WWWEWWWWWEWW
WEEEEEWWWEWW
WEEWWEWEEEEW
WWWEWYWEEWEW
WWYEGYWWYWWW
WEEWWEYEEEWW
WYWWWWEEWEWW
WWWWWWWWWWWW