WWWWWWWWWWWWWWWWWWWW
WEEEWEEWEEWEEEEEEEEW
WWWEEEEEWEWEEEEEEEEW
WWWEEWEWEEEEWWEWWEEW
WEEEEWEEWWEEWEEEWEWW
WEEEEEWEEWEWEEEWWEEW
WWEEEEEWEWWEGEEEEEEW
WWEEWEWWWWEWEEWEWEEW
WEWEEEEEWWEEEEWWEWEW
WEEEWEEWWEWEEWWEEWEW
WWWWWEEEWEEWEEEEWEEW
WEWEEEEEEEWEEEEEEEEW
WEEEWEEEWWEEEEEWWWEW
WEEEWEEEEWWEWWEWWEWW
WEWEWWEEEWEEEWEEEEWW
WEEWWEEWEEEEWEWEEEEW
WEWEWEEWEEEWEEEWEWEW
WEEEEWWEEWEEEEWEEEWW
WWWWEEEEWWEWEWEEEEWW
WWWWWWWWWWWWWWWWWWWW

WWWWWWWWWWWWWWWWWWWW
WEEEWEEWEEWEEEEEEEEW
WWWEEEEEWEWEEEEEEEEW
WWWEEWEWEEEEWWEWWEEW
WEEEEWEEWWEEWEEEWEWW
WEEEEEWEEWEWEEEWWEEW
WWEEEEEWEWWEGEEEEEEW
WWEEWEWWWWEWEEWEWEEW
WEWEEEEEWWEEEEWWEWEW
WEEEWEEWWEWEEWWEEWEW
WWWWWEEEWEEWEEEEWEEW
WEWEEEEEEEWEEEEEEEEW
WEEEWEEEWWEEEEEWWWEW
WEEEWEEEEWWEWWEWWEWW
WEWEWWEEEWEEEWEEEEWW
WEEWWEEWEEEEWEWEEEEW
WEWEWEEWEEEWEEEWEWEW
WEEEEWWEEWEEEEWEEEWW
WWWWEEEEWWEWEWEEEEWW
WWWWWWWWWWWWWWWWWWWW