WWWWWWWWWW
WWWWWWWWWW
WEEEEEWEEW
WWEWEEEWEW
WWEWWWEEEW
WEEWEWEEEW
WEEEEWEEWW
WEWGEWEEWW
WWEEWWEWWW
WWWWWWWWWW

WWWWWWWWWW
WWWWWWWWWW
WEEEEEWEEW
WWEWEEEWEW
WWEWWWEEEW
WEEWEWEEEW
WEEEEWEEWW
WEWGEWEEWW
WWEEWWEWWW
WWWWWWWWWW