WWWWWWWWWWWWWWWWWWWWWWWWWWWWWW
WWWWWWWWWWWWWWWWWWWWWWWWWWWWWW
WWWWWWWWWWWWWWWWWWWWWWWWWWWWWW
WWWWWWWWWWWWWWEEEEWWWWWWWWWWWW
WWWWWWWWWEEEEEEWGEWWWWWWWWWWWW
WWWWWWWWWEEEEEEEEEWWWWWWWWWWWW
WWWWWWWEEEEEWEEEEEWWWWWWWWWWWW
WWWWWWWEEEEEEEEEEWWWWWWWWWWWWW
WWWWWWWEEEEEEEEWWWWWWWWWWWWWWW
WWEEWWWEEEEWEEWWWWWWWWWWWWWWWW
WEEEEEEEEEEEEEWWWWWWWWWWWWWWWW
WEEEEEEEEEEEEEWWWWWWWWWWWWWWWW
WEEEEEEWEEEEEEEEWWWWWWWWWWWWWW
WEEEEEEEEEEEWWEEWWWWWWWWWWWWWW
WEEEEEWEEEEEEWEEEWWWWWWWWWWWWW
WEEEEEEEEEEEEEEEEEWWWWWWWWWWWW
WEEEEEEEEEEEEEEEEEWWWWWWWWWWWW
WEEEEEEEEEEEEEEEWWWWWWWWWWWWWW
WEEWWEEEEEEEEEEWWWWWWWWWWWWWWW
WEEEEEEEEEEEEEEWWWWWWWWWWWWWWW
WEEEEEEEEEWWEEEWWWWWWWWWWWWWWW
WEEEWEEEEEEEEWWWWWWWWWWWWWWWWW
WEEEEWEEWEWWWWWWWWWWWWWWWWWWWW
WEEEEWWWWWWWWWWWWWWWWWWWWWWWWW
WEEEEWWWWWWWWWWWWWWWWWWWWWWWWW
WWEEEWWWWWWWWWWWWWWWWWWWWWWWWW
WWWWWWWWWWWWWWWWWWWWWWWWWWWWWW
WWWWWWWWWWWWWWWWWWWWWWWWWWWWWW
WWWWWWWWWWWWWWWWWWWWWWWWWWWWWW
WWWWWWWWWWWWWWWWWWWWWWWWWWWWWW

WWWWWWWWWWWWWWWWWWWWWWWWWWWWWW
WWWWWWWWWWWWWWWWWWWWWWWWWWWWWW
WWWWWWWWWWWWWWWWWWWWWWWWWWWWWW
WWWWWWWWWWWWWWEEEEWWWWWWWWWWWW
WWWWWWWWWEEEEEEWGEWWWWWWWWWWWW
WWWWWWWWWEEEEEEEEEWWWWWWWWWWWW
WWWWWWWEEEEEWEEEEEWWWWWWWWWWWW
WWWWWWWEEEEEEEEEEWWWWWWWWWWWWW
WWWWWWWEEEEEEEEWWWWWWWWWWWWWWW
WWEEWWWEEEEWEEWWWWWWWWWWWWWWWW
WEEEEEEEEEEEEEWWWWWWWWWWWWWWWW
WEEEEEEEEEEEEEWWWWWWWWWWWWWWWW
WEEEEEEWEEEEEEEEWWWWWWWWWWWWWW
WEEEEEEEEEEEWWEEWWWWWWWWWWWWWW
WEEEEEWEEEEEEWEEEWWWWWWWWWWWWW
WEEEEEEEEEEEEEEEEEWWWWWWWWWWWW
WEEEEEEEEEEEEEEEEEWWWWWWWWWWWW
WEEEEEEEEEEEEEEEWWWWWWWWWWWWWW
WEEWWEEEEEEEEEEWWWWWWWWWWWWWWW
WEEEEEEEEEEEEEEWWWWWWWWWWWWWWW
WEEEEEEEEEWWEEEWWWWWWWWWWWWWWW
WEEEWEEEEEEEEWWWWWWWWWWWWWWWWW
WEEEEWEEWEWWWWWWWWWWWWWWWWWWWW
WEEEEWWWWWWWWWWWWWWWWWWWWWWWWW
WEEEEWWWWWWWWWWWWWWWWWWWWWWWWW
WWEEEWWWWWWWWWWWWWWWWWWWWWWWWW
WWWWWWWWWWWWWWWWWWWWWWWWWWWWWW
WWWWWWWWWWWWWWWWWWWWWWWWWWWWWW
WWWWWWWWWWWWWWWWWWWWWWWWWWWWWW
WWWWWWWWWWWWWWWWWWWWWWWWWWWWWW