WWWWWWWWWW
WEEEEEEWEW
WWEEEEEEEW
WEEEEWEWWW
WEEWEWEEWW
WWEWEEEGEW
WWEEEEEEEW
WEEEWWEWEW
WEWEWWEEEW
WWWWWWWWWW

WWWWWWWWWW
WEEEEEEWEW
WWEEEEEEEW
WEEEEWEWWW
WEEWEWEEWW
WWEWEEEGEW
WWEEEEEEEW
WEEEWWEWEW
WEWEWWEEEW
WWWWWWWWWW