WWWWWWWWWWWWWWWWWWWW
WEEEEDEEWEEEEDWEWEEW
WWEEEEEEEEDEEEEEGWEW
WEEEEEWEEEWDEEEEEWEW
WEEEEEEEWEEEEEEEWEEW
WEEEEEEEEEEEWEKEEEEW
WEWWEEEEWWEEWEEWEWEW
WEWEWEEKWWWEEEWEDEEW
WEEEEEWEEKEEWEEEEEWW
WWWEEEWEEWEEEEEEEEWW
WEEEEEWEWEEWWEEWEEEW
WWWEEEEEWEWWEWEWEWEW
WWWWEEEEWEEWEEEDEEWW
WEEEEEKEEEKEEEEWWEEW
WEEEEEEEEEEEEEWEEEEW
WEEEEWEEEWEEEEEEEEEW
WEWEWEEEEWEEEWEEEWWW
WEEEEEWEEWEEEEEEWEEW
WEEEEEEKWEEWWWESKEWW
WWWWWWWWWWWWWWWWWWWW

WWWWWWWWWWWWWWWWWWWW
WEEEEYEEWEEEEYWEWEEW
WWEEEEEEEEYEEEEEGWEW
WEEEEEWEEEWYEEEEEWEW
WEEEEEEEWEEEEEEEWEEW
WEEEEEEEEEEEWEYEEEEW
WEWWEEEEWWEEWEEWEWEW
WEWEWEEYWWWEEEWEYEEW
WEEEEEWEEYEEWEEEEEWW
WWWEEEWEEWEEEEEEEEWW
WEEEEEWEWEEWWEEWEEEW
WWWEEEEEWEWWEWEWEWEW
WWWWEEEEWEEWEEEYEEWW
WEEEEEYEEEYEEEEWWEEW
WEEEEEEEEEEEEEWEEEEW
WEEEEWEEEWEEEEEEEEEW
WEWEWEEEEWEEEWEEEWWW
WEEEEEWEEWEEEEEEWEEW
WEEEEEEYWEEWWWEEYEWW
WWWWWWWWWWWWWWWWWWWW