WWWWWWWWWWWWWWWWWWWW
WWWWWWWWWWWWWWWWWWWW
WWWWWWWWWWWWWWWWWWWW
WWWWWWWWWWWWWWWWWWWW
WWWWWWWWEEWWWWWWEEEW
WWWWWWEEEEWWWWWWKKEW
WWWWWWEDEKEEWWWWDDEW
WWWWWWWEEEEEWWWEEEEW
WWWWWWDKWWEKWWWDEEEW
WWWWWWEKEKEKEDEEEKKW
WWWWWEEEEWWESWEEWEEW
WWWWEEEEEWEKKEDKWEEW
WWWWDEEEEEEWKEEEWEEW
WWWWWEEEEEEGEEEEKDEW
WWWWWKEEEEEEKEEWEKEW
WWWWWEKEEEEEEEEEEEEW
WWWWWWWEEEEEDEEEEEEW
WWWWWWWEEKEEEEEEWDEW
WWWWWWWWWWEEDKEEEKKW
WWWWWWWWWWWWWWWWWWWW

WWWWWWWWWWWWWWWWWWWW
WWWWWWWWWWWWWWWWWWWW
WWWWWWWWWWWWWWWWWWWW
WWWWWWWWWWWWWWWWWWWW
WWWWWWWWEEWWWWWWEEEW
WWWWWWEEEEWWWWWWYYEW
WWWWWWEYEYEEWWWWYYEW
WWWWWWWEEEEEWWWEEEEW
WWWWWWYYWWEYWWWYEEEW
WWWWWWEYEYEYEYEEEYYW
WWWWWEEEEWWEEWEEWEEW
WWWWEEEEEWEYYEYYWEEW
WWWWYEEEEEEWYEEEWEEW
WWWWWEEEEEEGEEEEYYEW
WWWWWYEEEEEEYEEWEYEW
WWWWWEYEEEEEEEEEEEEW
WWWWWWWEEEEEYEEEEEEW
WWWWWWWEEYEEEEEEWYEW
WWWWWWWWWWEEYYEEEYYW
WWWWWWWWWWWWWWWWWWWW