WWWWWWWWWWWWWWWWWW
WEKEEEEEWEWEEWEEEW
WEEEEEEWEEEWEEKEEW
WEEEEEEEEEEEEEEEEW
WEEEEEEEEEEEEEEEWW
WEEEWEEEEEWEEWEEEW
WEEEEEEEEEEEEEEEEW
WEEWEEEEEEWEEWEEWW
WEEEEEEEEDGEEEEEEW
WEEEEWEEWEEEEEEWEW
WEEEEEWEWWDEEEEEEW
WEEEEEEEEEEEEEWEEW
WEEEEEWEEEEEEEEEEW
WEEEEWSEEEEWEEEEEW
WEWEEEKEEEWWEWEEEW
WEWEEEEEEWEEEEEEEW
WEEEEEEEEEEKEWEEEW
WWWWWWWWWWWWWWWWWW

WWWWWWWWWWWWWWWWWW
WEYEEEEEWEWEEWEEEW
WEEEEEEWEEEWEEYEEW
WEEEEEEEEEEEEEEEEW
WEEEEEEEEEEEEEEEWW
WEEEWEEEEEWEEWEEEW
WEEEEEEEEEEEEEEEEW
WEEWEEEEEEWEEWEEWW
WEEEEEEEEYGEEEEEEW
WEEEEWEEWEEEEEEWEW
WEEEEEWEWWYEEEEEEW
WEEEEEEEEEEEEEWEEW
WEEEEEWEEEEEEEEEEW
WEEEEWEEEEEWEEEEEW
WEWEEEYEEEWWEWEEEW
WEWEEEEEEWEEEEEEEW
WEEEEEEEEEEYEWEEEW
WWWWWWWWWWWWWWWWWW