WWWWWWWWWW
WEEEEEEEEW
WWEEEEEEEW
WEEEEWWEEW
WWWWWEEEWW
WWEEEEEWEW
WEWEEEGEEW
WEEEEEWEWW
WEEEWEEEEW
WWWWWWWWWW

WWWWWWWWWW
WEEEEEEEEW
WWEEEEEEEW
WEEEEWWEEW
WWWWWEEEWW
WWEEEEEWEW
WEWEEEGEEW
WEEEEEWEWW
WEEEWEEEEW
WWWWWWWWWW