WWWWWWWWWWWWWWWWWWWW
WEWEWEEEEEEEEEEWEEEW
WEEEEEEWEEWEWEEEEEEW
WEWWEEEEEEEEEEEEWEEW
WEEWEWEEEEEEEEEEEEEW
WEEEEEEEEWEWEEEWWEEW
WEEWEEWWEEEEEEWEEEEW
WEEEEWEWEEEWEEEEEEEW
WEEEEEEWEEWEEEWEEEWW
WEEEEEEEWEWWEEEEEEEW
WEEEEEEEEEEEEEEEEEWW
WEEEEEWEEEEEWEEEEEEW
WEEEEWEEEEEEEEEEEWEW
WEEEEEEEEEEEEWWEEEEW
WEEEWWEWEEEEWEEEEEEW
WEWEEEWWEWEEEEEEEEEW
WWEEEEWWEEEEEEEWEEGW
WEEEEWWEEWWWEEEEEEEW
WEEWEEEEEEWEEEEEEEEW
WWWWWWWWWWWWWWWWWWWW

WWWWWWWWWWWWWWWWWWWW
WEWEWEEEEEEEEEEWEEEW
WEEEEEEWEEWEWEEEEEEW
WEWWEEEEEEEEEEEEWEEW
WEEWEWEEEEEEEEEEEEEW
WEEEEEEEEWEWEEEWWEEW
WEEWEEWWEEEEEEWEEEEW
WEEEEWEWEEEWEEEEEEEW
WEEEEEEWEEWEEEWEEEWW
WEEEEEEEWEWWEEEEEEEW
WEEEEEEEEEEEEEEEEEWW
WEEEEEWEEEEEWEEEEEEW
WEEEEWEEEEEEEEEEEWEW
WEEEEEEEEEEEEWWEEEEW
WEEEWWEWEEEEWEEEEEEW
WEWEEEWWEWEEEEEEEEEW
WWEEEEWWEEEEEEEWEEGW
WEEEEWWEEWWWEEEEEEEW
WEEWEEEEEEWEEEEEEEEW
WWWWWWWWWWWWWWWWWWWW