WWWWWWWWWWWWWWWWWWWWWWWWWWWWWW
WEWEEEEEEEEEEEEEWEEEEEEWEEWWEW
WEWEEEWEEEEWEEEWEEWEWWEEEWEEEW
WEEEEEEEEWEEEWEEEEEEEWWEWEEEEW
WEEEEWEEEEEEEEEEEEEWEEEEWEEWEW
WEWWEWEEEEWEEEEEWWEEEEWEGEEEEW
WWEEEEEEEEEEEEEEEEEEEEWEEEEEEW
WEEEEWWEEEEEEEWWEEEEEEEEWEEEEW
WEEEEEWEEEEEEEWEEEEEWWEWEEWEWW
WEWEEEEEEEEWEEWEEEEEWEEEEEEEEW
WEEEEEWWEWWWEEEEWEEWWEEEEEEWEW
WWEWWEEWEEEEEWEEEEEEEEEEEEEEEW
WWEWEEEEEEWEEEEEWWEEEEEEWEWEEW
WEWWEEEEEEEEEEEEWEEEEEEEWWEWEW
WEEEEEEEEWEEWEWWEWEEEEWEEEEEEW
WEEEEEEEEEWEWEEEEEEEWEEWWWEEEW
WEEWEWWEEEEWWEEEEEEWEEEWEWEWEW
WEEEEWEEEEEWEEWWEEEEEWEEEEWEEW
WEEEEWEWEEEEEEEEEEEEEEEEEEEEEW
WWEEEEWEWWEEEWWEEEEWEEEEEEEEEW
WEEWEEWEEWEEEEEWEEEEEEEEEEEEEW
WEWEEEEWEEEEEEEWEEEEEEWEEEEEWW
WEWEEWEEEEEEEEEEEEEEEEEWEWEEEW
WEEWWEEWEEEEEWEEEWEWEEEWEEEEEW
WEWEEEEEEEEEEEWEEEEEWEEEEWWEEW
WEEEEEEWEWEEEEEWWEWEWWEEEEEWWW
WEEEEEEWEWEEWEEWEEEEEEEEEEEEEW
WEEEEEEWEEEEWEEEEWEEEEEEEEWWWW
WEEEEEEEEEEEEEEEEEEEWWEEEEEEEW
WWWWWWWWWWWWWWWWWWWWWWWWWWWWWW

WWWWWWWWWWWWWWWWWWWWWWWWWWWWWW
WEWEEEEEEEEEEEEEWEEEEEEWEEWWEW
WEWEEEWEEEEWEEEWEEWEWWEEEWEEEW
WEEEEEEEEWEEEWEEEEEEEWWEWEEEEW
WEEEEWEEEEEEEEEEEEEWEEEEWEEWEW
WEWWEWEEEEWEEEEEWWEEEEWEGEEEEW
WWEEEEEEEEEEEEEEEEEEEEWEEEEEEW
WEEEEWWEEEEEEEWWEEEEEEEEWEEEEW
WEEEEEWEEEEEEEWEEEEEWWEWEEWEWW
WEWEEEEEEEEWEEWEEEEEWEEEEEEEEW
WEEEEEWWEWWWEEEEWEEWWEEEEEEWEW
WWEWWEEWEEEEEWEEEEEEEEEEEEEEEW
WWEWEEEEEEWEEEEEWWEEEEEEWEWEEW
WEWWEEEEEEEEEEEEWEEEEEEEWWEWEW
WEEEEEEEEWEEWEWWEWEEEEWEEEEEEW
WEEEEEEEEEWEWEEEEEEEWEEWWWEEEW
WEEWEWWEEEEWWEEEEEEWEEEWEWEWEW
WEEEEWEEEEEWEEWWEEEEEWEEEEWEEW
WEEEEWEWEEEEEEEEEEEEEEEEEEEEEW
WWEEEEWEWWEEEWWEEEEWEEEEEEEEEW
WEEWEEWEEWEEEEEWEEEEEEEEEEEEEW
WEWEEEEWEEEEEEEWEEEEEEWEEEEEWW
WEWEEWEEEEEEEEEEEEEEEEEWEWEEEW
WEEWWEEWEEEEEWEEEWEWEEEWEEEEEW
WEWEEEEEEEEEEEWEEEEEWEEEEWWEEW
WEEEEEEWEWEEEEEWWEWEWWEEEEEWWW
WEEEEEEWEWEEWEEWEEEEEEEEEEEEEW
WEEEEEEWEEEEWEEEEWEEEEEEEEWWWW
WEEEEEEEEEEEEEEEEEEEWWEEEEEEEW
WWWWWWWWWWWWWWWWWWWWWWWWWWWWWW