WWWWWWWWWWWWWWWWWWWW
WWWWWWWWWWWWWWWWWWWW
WWWWWWWWWWWWWWWWEEWW
WWWWWWWWWWWWWWWDEEEW
WWWWWWWWWWWWWWWKWEEW
WWWWWWWWWWWWWWWEDEEW
WWWWWWWWWWWWWWWWEKEW
WWWWWWWWWWWWEEEEEDEW
WWWWWWWWWWWWWEEEEDEW
WWWWWWWWWWWWEEWEKEWW
WWWWWWWWWWWWEEEEEEEW
WWWWWWWWWWWWEEEEEEEW
WWWWWWWWWWWWWWEDEEEW
WWWWWWWWWWWWWWKDEEWW
WWWWWWWWWWWWWWKEEDEW
WWWWWWWWWWWWWEEEKEEW
WWWWWWWWWWWWWEEEEEDW
WWWWWWWWWWWWWWWWWEKW
WWWWWWWWWWWWWWWWWGDW
WWWWWWWWWWWWWWWWWWWW

WWWWWWWWWWWWWWWWWWWW
WWWWWWWWWWWWWWWWWWWW
WWWWWWWWWWWWWWWWEEWW
WWWWWWWWWWWWWWWYEEEW
WWWWWWWWWWWWWWWYWEEW
WWWWWWWWWWWWWWWEYEEW
WWWWWWWWWWWWWWWWEYEW
WWWWWWWWWWWWEEEEEYEW
WWWWWWWWWWWWWEEEEYEW
WWWWWWWWWWWWEEWEYEWW
WWWWWWWWWWWWEEEEEEEW
WWWWWWWWWWWWEEEEEEEW
WWWWWWWWWWWWWWEYEEEW
WWWWWWWWWWWWWWYYEEWW
WWWWWWWWWWWWWWYEEYEW
WWWWWWWWWWWWWEEEYEEW
WWWWWWWWWWWWWEEEEEYW
WWWWWWWWWWWWWWWWWEYW
WWWWWWWWWWWWWWWWWGYW
WWWWWWWWWWWWWWWWWWWW