WWWWWWWWWWWWWWWWWWWWWWWWWWWWWW
WEEEEEWEEEEEWEEEEWEEEEEEEEWEEW
WEEEEEEEEEEGWEWWWWEEEWWWEEEEEW
WEEWWWEEEEEEEEEEEEEWWEEWWEEEEW
WEEEEWEWEWEWEEEEEWEEEEEEEEEEEW
WEWEWWEEEEEEWEEWEEEEEEEWWWEEEW
WEEEEEEEEEWEEEEEWEWWEEEWEEWEEW
WEEEEEWEEEEEWEEEWWEWEEEEEEWEEW
WEEEEEEEEEEWEWEEWEEEEEWEEEEEEW
WEWEEEEEEWEEEEEEEEEEEWEEWEEEEW
WEWEEEWEEEEEEEEWEWEEEEEEEEEWEW
WEEEEEEWEEWWEWEEEWEWEEEWEEWEWW
WEEEEEEWEEEWEWEWEEWEEEWEWWWEEW
WWEEEEEWWEEWEEWEWEEEWEEEEEEWEW
WEEEEEEEEEWEEWWEEEEEEEEEEWEEEW
WEWEEEWWEWEEEEEWEEEEWEWEEWEEWW
WWEWEEEWEWEEWEWEWEEEEEWEEEWEEW
WEEEWWWEEEEEEEWEEEWWEEWEWEEWWW
WWEEEWEWEEWEEWWWEEEWEEEEEEEEEW
WEWWEWEEEEWEEEWEEEEEWWWWEEWEWW
WEEEEEWEEEEEEEEEEEEEWEEEEEEWWW
WEWEEEWEEWEEEWEEEWEWEWEEEEEEEW
WEEWEEEEEEEEEEEEEEEEEWEEEEEEEW
WEEEEWEEEEWEWEEEEEEEEEEEEWEWEW
WEEEEWEEEEEEEEWEEEWEEEEEEEEWEW
WEEEEWEEEWEEEEEEEEWWEWEEEWEEEW
WEEEEWEEEEEWEEWWWEWEWEEEEWEWEW
WEEEEEEEWEEEWEEEEEWEEEEEEEEEWW
WEEEEWEEEEWWEEEEWEWEWEEWEWEWWW
WWWWWWWWWWWWWWWWWWWWWWWWWWWWWW

WWWWWWWWWWWWWWWWWWWWWWWWWWWWWW
WEEEEEWEEEEEWEEEEWEEEEEEEEWEEW
WEEEEEEEEEEGWEWWWWEEEWWWEEEEEW
WEEWWWEEEEEEEEEEEEEWWEEWWEEEEW
WEEEEWEWEWEWEEEEEWEEEEEEEEEEEW
WEWEWWEEEEEEWEEWEEEEEEEWWWEEEW
WEEEEEEEEEWEEEEEWEWWEEEWEEWEEW
WEEEEEWEEEEEWEEEWWEWEEEEEEWEEW
WEEEEEEEEEEWEWEEWEEEEEWEEEEEEW
WEWEEEEEEWEEEEEEEEEEEWEEWEEEEW
WEWEEEWEEEEEEEEWEWEEEEEEEEEWEW
WEEEEEEWEEWWEWEEEWEWEEEWEEWEWW
WEEEEEEWEEEWEWEWEEWEEEWEWWWEEW
WWEEEEEWWEEWEEWEWEEEWEEEEEEWEW
WEEEEEEEEEWEEWWEEEEEEEEEEWEEEW
WEWEEEWWEWEEEEEWEEEEWEWEEWEEWW
WWEWEEEWEWEEWEWEWEEEEEWEEEWEEW
WEEEWWWEEEEEEEWEEEWWEEWEWEEWWW
WWEEEWEWEEWEEWWWEEEWEEEEEEEEEW
WEWWEWEEEEWEEEWEEEEEWWWWEEWEWW
WEEEEEWEEEEEEEEEEEEEWEEEEEEWWW
WEWEEEWEEWEEEWEEEWEWEWEEEEEEEW
WEEWEEEEEEEEEEEEEEEEEWEEEEEEEW
WEEEEWEEEEWEWEEEEEEEEEEEEWEWEW
WEEEEWEEEEEEEEWEEEWEEEEEEEEWEW
WEEEEWEEEWEEEEEEEEWWEWEEEWEEEW
WEEEEWEEEEEWEEWWWEWEWEEEEWEWEW
WEEEEEEEWEEEWEEEEEWEEEEEEEEEWW
WEEEEWEEEEWWEEEEWEWEWEEWEWEWWW
WWWWWWWWWWWWWWWWWWWWWWWWWWWWWW