WWWWWWWWWWWWWWWWWWWWWWWWWWWWWW
WEEEEEEEEEEEEEWEEEEEEEEEEEWEEW
WEEEEEEWEEEEEEEEEEEWEEEEEEEEWW
WEEEEWEEEEEEWWEEWEWEEWEEEEEEWW
WEEEEEEEWEEEEEEEEEEEWEEEEEEEEW
WEEWEEWEEEEEEWEEEEEEEEEEEEEWEW
WEEEEEEEEEEEEEEEEEEEEEEEWEEEEW
WEEEEEEEWEEEEWEEEEEWEEEWEEEEEW
WEEEEEEEEEEEEEWEEEEEWEEEEEEEEW
WEEEEEEWEEEEEEEEEEEWEEEEEWEEEW
WEEEEEEEEEEEEWEEEEEEEEEEEWEWEW
WEEEEEEEEEEEEEEEEEEEEEEEWEEWEW
WEEEEEEEEEEWEEEEWEEEEEEEEEEEEW
WEEEEEWEEWEEEEEEEEEEEEEEWEEEEW
WEEEEEEEEWEWWEEEEEEEEEEEEEWEWW
WEEEEEEEWEEEWEEEEEEEEEEWEEEEEW
WWEEEEEEEEEEEEEEEEEWWEWEEEEEEW
WEEEEEEEEEEWEEEEEEEEEEEEEEEEEW
WEEEEEEEGEEEEEEEEWEEEEEWEEEEEW
WEEEWEEEEEEWEEEEEEEEEEWEEEEEEW
WEWEEEEEEEEEEEWEEEWEWEEEEEEEEW
WEEEEEEWEEEEEEEEEEEEEEEEEWEEEW
WEEEEEEEEEEEEEEEEWEEEEEEEEEEEW
WEEEEEEEWWEEEEWEEEEEWEEWEEEWWW
WEEEEEWEEEEEEEEEEEEEEEEEEEWEEW
WEEEEEEEEEEEWEEEEEEEEEEEEEEEEW
WEEEEEEEEEEWEEEEEWEEEEEEEWEEEW
WEEWEEEEEEEWEEEEEEEEEEEEEEEEEW
WEEEEEWEWEEEEEWEEEEEEEEEEEEEEW
WWWWWWWWWWWWWWWWWWWWWWWWWWWWWW

WWWWWWWWWWWWWWWWWWWWWWWWWWWWWW
WEEEEEEEEEEEEEWEEEEEEEEEEEWEEW
WEEEEEEWEEEEEEEEEEEWEEEEEEEEWW
WEEEEWEEEEEEWWEEWEWEEWEEEEEEWW
WEEEEEEEWEEEEEEEEEEEWEEEEEEEEW
WEEWEEWEEEEEEWEEEEEEEEEEEEEWEW
WEEEEEEEEEEEEEEEEEEEEEEEWEEEEW
WEEEEEEEWEEEEWEEEEEWEEEWEEEEEW
WEEEEEEEEEEEEEWEEEEEWEEEEEEEEW
WEEEEEEWEEEEEEEEEEEWEEEEEWEEEW
WEEEEEEEEEEEEWEEEEEEEEEEEWEWEW
WEEEEEEEEEEEEEEEEEEEEEEEWEEWEW
WEEEEEEEEEEWEEEEWEEEEEEEEEEEEW
WEEEEEWEEWEEEEEEEEEEEEEEWEEEEW
WEEEEEEEEWEWWEEEEEEEEEEEEEWEWW
WEEEEEEEWEEEWEEEEEEEEEEWEEEEEW
WWEEEEEEEEEEEEEEEEEWWEWEEEEEEW
WEEEEEEEEEEWEEEEEEEEEEEEEEEEEW
WEEEEEEEGEEEEEEEEWEEEEEWEEEEEW
WEEEWEEEEEEWEEEEEEEEEEWEEEEEEW
WEWEEEEEEEEEEEWEEEWEWEEEEEEEEW
WEEEEEEWEEEEEEEEEEEEEEEEEWEEEW
WEEEEEEEEEEEEEEEEWEEEEEEEEEEEW
WEEEEEEEWWEEEEWEEEEEWEEWEEEWWW
WEEEEEWEEEEEEEEEEEEEEEEEEEWEEW
WEEEEEEEEEEEWEEEEEEEEEEEEEEEEW
WEEEEEEEEEEWEEEEEWEEEEEEEWEEEW
WEEWEEEEEEEWEEEEEEEEEEEEEEEEEW
WEEEEEWEWEEEEEWEEEEEEEEEEEEEEW
WWWWWWWWWWWWWWWWWWWWWWWWWWWWWW