WWWWWWWWWWWWWWWWWWWWWWWWWWWWWW
WEEEEEWEEWEEEEEEEWEEEEEEEEEEWW
WEEWEWEWEEEEEEEEEWWEEEWWEEEWWW
WEEEEEEEEEEEEEEEWEEEEEWWEEEWWW
WEWEEWEEEEEWWEEEEWEEEEWEEEEEEW
WEEEEEEWEWEWEWEWEEEEWWEEEEWEEW
WWEEWEEEEEWWEEEEWEWEEEEEEWEEEW
WWWWEEEEEEWWEEEEEWEEEEEEEEWEEW
WEWWWEEWEWEEEEWEEEWEWEEWWEWWEW
WEEEEEEEWEEEEEWEWEEEEEWWEEEEWW
WWEEWEEEWEEWEWEEEEEEWEEWEEEWEW
WEEEWWWEWEEEWEWEEEWEEWEEEEEEEW
WWEEEEEWGEEWEEEWEEEEEWEEWWEEWW
WEEWEEWEEEEEEEEWEEEWWWWEEEWEWW
WEWWWEWEEWEEEEEWWEEEEWEEWEEEEW
WEWEWEEEEEEEEEEEEEEEEEWEEWEEEW
WEEEEEEEEEWEEWEEEEEWEEEWEEEEWW
WEEEEEWEWEEEEWEWEEEEEEEWEEEEEW
WEEWWEEEEWEEEEEWWEEEEWWEWEEEEW
WWEEEEEEEEEWEWEEEEWEWWWEEEEEEW
WEEEEEEEEWEEEEEWWEEEEEEEEWWEWW
WEEWEEEEEEEEEEEEWWEEEEEWEEEWWW
WEEEEEEEEEEEEEWEEEEEWEEEEEEEWW
WEEWEWWEEWEEEEEEEWEEEEEEEEEWWW
WEEWWEEEEEWEEWEEEEEEEEEEEEEEWW
WEEEEWEWEWEEEEEWEEWEWEWEEEEEEW
WEEEEEWEWEEWWWEEEEEEEEWEEEWEEW
WEEEEEEEWEEWWEWEEWWEWEEEEEEEEW
WEWEWEEEEEWWEEEEEEWEEEEEEEEWEW
WWWWWWWWWWWWWWWWWWWWWWWWWWWWWW

WWWWWWWWWWWWWWWWWWWWWWWWWWWWWW
WEEEEEWEEWEEEEEEEWEEEEEEEEEEWW
WEEWEWEWEEEEEEEEEWWEEEWWEEEWWW
WEEEEEEEEEEEEEEEWEEEEEWWEEEWWW
WEWEEWEEEEEWWEEEEWEEEEWEEEEEEW
WEEEEEEWEWEWEWEWEEEEWWEEEEWEEW
WWEEWEEEEEWWEEEEWEWEEEEEEWEEEW
WWWWEEEEEEWWEEEEEWEEEEEEEEWEEW
WEWWWEEWEWEEEEWEEEWEWEEWWEWWEW
WEEEEEEEWEEEEEWEWEEEEEWWEEEEWW
WWEEWEEEWEEWEWEEEEEEWEEWEEEWEW
WEEEWWWEWEEEWEWEEEWEEWEEEEEEEW
WWEEEEEWGEEWEEEWEEEEEWEEWWEEWW
WEEWEEWEEEEEEEEWEEEWWWWEEEWEWW
WEWWWEWEEWEEEEEWWEEEEWEEWEEEEW
WEWEWEEEEEEEEEEEEEEEEEWEEWEEEW
WEEEEEEEEEWEEWEEEEEWEEEWEEEEWW
WEEEEEWEWEEEEWEWEEEEEEEWEEEEEW
WEEWWEEEEWEEEEEWWEEEEWWEWEEEEW
WWEEEEEEEEEWEWEEEEWEWWWEEEEEEW
WEEEEEEEEWEEEEEWWEEEEEEEEWWEWW
WEEWEEEEEEEEEEEEWWEEEEEWEEEWWW
WEEEEEEEEEEEEEWEEEEEWEEEEEEEWW
WEEWEWWEEWEEEEEEEWEEEEEEEEEWWW
WEEWWEEEEEWEEWEEEEEEEEEEEEEEWW
WEEEEWEWEWEEEEEWEEWEWEWEEEEEEW
WEEEEEWEWEEWWWEEEEEEEEWEEEWEEW
WEEEEEEEWEEWWEWEEWWEWEEEEEEEEW
WEWEWEEEEEWWEEEEEEWEEEEEEEEWEW
WWWWWWWWWWWWWWWWWWWWWWWWWWWWWW