WWWWWWWWWWWWWWWWWWWW
WEWEEEEEEWEEEEEEWEEW
WEWEEEEEEEEWEEEEEEEW
WEEEEEEEEWEEEEEEEEEW
WEEEEEEEEEEEEEEEEEEW
WEEEEEEEEEWEWEEEEEEW
WWEEEEEWEEEEEEWEEEEW
WEEEWWEEEEEEEEEEEEEW
WEEEEEEEWEEWWEEEEEWW
WEEEEEWEEEWWEWEEWWEW
WEEEEEEEWWEEEEEEEEEW
WEEEEWEEEEEEWEEEEEEW
WEEEEEEEEEEEWEEGEWEW
WEEEEEEEEEEEEEEEEEEW
WEEEEEEWEEEWEEEEWEEW
WEEEEEEWEEEEEEWEEEEW
WEEEEEEEEEEEEEEEEWWW
WEEEEWEWEEEWEEEEEEEW
WEEEEEEEEWEEEEEEEEEW
WWWWWWWWWWWWWWWWWWWW

WWWWWWWWWWWWWWWWWWWW
WEWEEEEEEWEEEEEEWEEW
WEWEEEEEEEEWEEEEEEEW
WEEEEEEEEWEEEEEEEEEW
WEEEEEEEEEEEEEEEEEEW
WEEEEEEEEEWEWEEEEEEW
WWEEEEEWEEEEEEWEEEEW
WEEEWWEEEEEEEEEEEEEW
WEEEEEEEWEEWWEEEEEWW
WEEEEEWEEEWWEWEEWWEW
WEEEEEEEWWEEEEEEEEEW
WEEEEWEEEEEEWEEEEEEW
WEEEEEEEEEEEWEEGEWEW
WEEEEEEEEEEEEEEEEEEW
WEEEEEEWEEEWEEEEWEEW
WEEEEEEWEEEEEEWEEEEW
WEEEEEEEEEEEEEEEEWWW
WEEEEWEWEEEWEEEEEEEW
WEEEEEEEEWEEEEEEEEEW
WWWWWWWWWWWWWWWWWWWW