WWWWWWWWWWWWWWWWWWWW
WSEEEEWDEEEWWEEEEEEW
WKEWEWEEEEEEEEEEEGEW
WEEEEEEWEEWEEWEEEEEW
WEEWWEEEEEEEEEEEWDEW
WEEWEEEEEEEWEDWEEWWW
WEEEEEEEEEEEEEWEEWEW
WEEEEEWEEEEEEEEEWEEW
WEEEEEEEEEEEEEEEWEDW
WEEEEEEEEEEEEEEEEEWW
WEEEWEEEEEEEEEEEEEEW
WEWEEEEEEKEKEWEEEEEW
WEEEEEEEEDWWEWEEEEEW
WEEEEEEEEEEEWEEEEEEW
WWEEEEEEEEEEDEEEEEEW
WEEWWWWWEEWEKEEEEEEW
WEEWEEEEEEEWEEEEEEEW
WEEWEEEEEEEEEWEEEEEW
WEEEEEEEEEEEWEEEWEEW
WWWWWWWWWWWWWWWWWWWW

WWWWWWWWWWWWWWWWWWWW
WEEEEEWYEEEWWEEEEEEW
WYEWEWEEEEEEEEEEEGEW
WEEEEEEWEEWEEWEEEEEW
WEEWWEEEEEEEEEEEWYEW
WEEWEEEEEEEWEYWEEWWW
WEEEEEEEEEEEEEWEEWEW
WEEEEEWEEEEEEEEEWEEW
WEEEEEEEEEEEEEEEWEYW
WEEEEEEEEEEEEEEEEEWW
WEEEWEEEEEEEEEEEEEEW
WEWEEEEEEYEYEWEEEEEW
WEEEEEEEEYWWEWEEEEEW
WEEEEEEEEEEEWEEEEEEW
WWEEEEEEEEEEYEEEEEEW
WEEWWWWWEEWEYEEEEEEW
WEEWEEEEEEEWEEEEEEEW
WEEWEEEEEEEEEWEEEEEW
WEEEEEEEEEEEWEEEWEEW
WWWWWWWWWWWWWWWWWWWW