WWWWWWWWWWWWWWWWWW
WEWEEEEEEEKEEEEEEW
WEEEWEEEEEEEEEEEEW
WWEEWEEEEEWEEEEEWW
WEEEEEEEEEEEEWWEEW
WWEEWEEEWEEEWEEWEW
WEEEWEEEEEEEEEEEEW
WEEEEEEEEEEEEEEEEW
WEEEEEEEEEEEWEEEEW
WEEEESEEEEEWEEEEEW
WEEEEKEEEEWEEWEEEW
WEEEEEGEEEEEEEEEEW
WEWEEEEEEEEEEEDEWW
WEEEEEEEWEWEEEEEEW
WWEWEEEEWEEEEEEEEW
WEEDEWWEEEEWEEEEEW
WEKEEEEEEEEEEEEEWW
WWWWWWWWWWWWWWWWWW

WWWWWWWWWWWWWWWWWW
WEWEEEEEEEYEEEEEEW
WEEEWEEEEEEEEEEEEW
WWEEWEEEEEWEEEEEWW
WEEEEEEEEEEEEWWEEW
WWEEWEEEWEEEWEEWEW
WEEEWEEEEEEEEEEEEW
WEEEEEEEEEEEEEEEEW
WEEEEEEEEEEEWEEEEW
WEEEEEEEEEEWEEEEEW
WEEEEYEEEEWEEWEEEW
WEEEEEGEEEEEEEEEEW
WEWEEEEEEEEEEEYEWW
WEEEEEEEWEWEEEEEEW
WWEWEEEEWEEEEEEEEW
WEEYEWWEEEEWEEEEEW
WEYEEEEEEEEEEEEEWW
WWWWWWWWWWWWWWWWWW