WWWWWWWWWWWWWWWWWWWW
WEEEEEEEWWWWWWWWWWWW
WEEEEEEEWWWWWWWWWWWW
WEEEEEEEWWWWWWWWWWWW
WEEEEEEEEWWWWWWWWWWW
WEEEEEEGEWWWWWWWWWWW
WEEEEEEEEEEWWWWWWWWW
WWEEEEEEEEEWWWWWWWWW
WWEEEEWEEEEWWWWWWWWW
WWEEWWWEEEEEEWWWWWWW
WWWWWWWWWWWWWWWWWWWW
WWWWWWWWWWWWWWWWWWWW
WWWWWWWWWWWWWWWWWWWW
WWWWWWWWWWWWWWWWWWWW
WWWWWWWWWWWWWWWWWWWW
WWWWWWWWWWWWWWWWWWWW
WWWWWWWWWWWWWWWWWWWW
WWWWWWWWWWWWWWWWWWWW
WWWWWWWWWWWWWWWWWWWW
WWWWWWWWWWWWWWWWWWWW

WWWWWWWWWWWWWWWWWWWW
WEEEEEEEWWWWWWWWWWWW
WEEEEEEEWWWWWWWWWWWW
WEEEEEEEWWWWWWWWWWWW
WEEEEEEEEWWWWWWWWWWW
WEEEEEEGEWWWWWWWWWWW
WEEEEEEEEEEWWWWWWWWW
WWEEEEEEEEEWWWWWWWWW
WWEEEEWEEEEWWWWWWWWW
WWEEWWWEEEEEEWWWWWWW
WWWWWWWWWWWWWWWWWWWW
WWWWWWWWWWWWWWWWWWWW
WWWWWWWWWWWWWWWWWWWW
WWWWWWWWWWWWWWWWWWWW
WWWWWWWWWWWWWWWWWWWW
WWWWWWWWWWWWWWWWWWWW
WWWWWWWWWWWWWWWWWWWW
WWWWWWWWWWWWWWWWWWWW
WWWWWWWWWWWWWWWWWWWW
WWWWWWWWWWWWWWWWWWWW