WWWWWWWWWW
WEWEEEEEEW
WEEWWEEEWW
WEEEEWEEEW
WWEWEEEEWW
WEEWEEWEEW
WEWEEEEEEW
WEEEEEEEWW
WEEEEGWEWW
WWWWWWWWWW

WWWWWWWWWW
WEWEEEEEEW
WEEWWEEEWW
WEEEEWEEEW
WWEWEEEEWW
WEEWEEWEEW
WEWEEEEEEW
WEEEEEEEWW
WEEEEGWEWW
WWWWWWWWWW