WWWWWWWWWWWWWWWWWWWW
WKWEEEEEEEWEWWEEEEEW
WEWEWEEEEWEKEEWEEWDW
WEWWEEEEEWEEEEEWEEEW
WEEWEWWWEEWEEEWEEEEW
WWEEEEEEWEWEEEEEEEEW
WEEEEEEEWWEEEEDEEEEW
WEEEEWEEEEEEWEEEEEEW
WEEWWEEEEEEEEWWEEEEW
WEEEGEEEDEWEWEEEEEEW
WEWEEEEEEEWEWEEEEEEW
WEDKEEWEEEEEEEEDEWEW
WEEWEEEWEEEWEEEEEEEW
WEEEEEEWEEEEEEEKWEEW
WWEEWWEEEEEEEEEEEEEW
WEEEEEEEEEWEEWEEEWEW
WEEWDEEEEEWEEEEEEEEW
WEEEKEEEWEEEEEEWEWWW
WEDEEEEEEEEEEEEWEEEW
WWWWWWWWWWWWWWWWWWWW

WWWWWWWWWWWWWWWWWWWW
WYWEEEEEEEWEWWEEEEEW
WEWEWEEEEWEYEEWEEWYW
WEWWEEEEEWEEEEEWEEEW
WEEWEWWWEEWEEEWEEEEW
WWEEEEEEWEWEEEEEEEEW
WEEEEEEEWWEEEEYEEEEW
WEEEEWEEEEEEWEEEEEEW
WEEWWEEEEEEEEWWEEEEW
WEEEGEEEYEWEWEEEEEEW
WEWEEEEEEEWEWEEEEEEW
WEYYEEWEEEEEEEEYEWEW
WEEWEEEWEEEWEEEEEEEW
WEEEEEEWEEEEEEEYWEEW
WWEEWWEEEEEEEEEEEEEW
WEEEEEEEEEWEEWEEEWEW
WEEWYEEEEEWEEEEEEEEW
WEEEYEEEWEEEEEEWEWWW
WEYEEEEEEEEEEEEWEEEW
WWWWWWWWWWWWWWWWWWWW