WWWWWWWWWWWWWWWWWWWW
WWWWEWWEWEEEKKWEEEEW
WWEESWEEEEEWWEWEEEEW
WWEEKWWEEEEEEEEEEKDW
WEEEWEEEEEEEEWEEWEEW
WEEEEEEWEEKWEEEEEEEW
WEWEEEGWEEEEEEDEEEEW
WDEEEEEEWEEEEEEEEEEW
WEEEEEEEWEEWEEEWEEEW
WEEEEEEEEEEEEEEEWWEW
WEEEEWEWEEEEEWEEEWEW
WEWEEEEWWEEEEEEEWEDW
WKEEEEWWWEEEEEEEWEEW
WEEEEWEWEWEEEEEEEEEW
WEEEEEEEEEWEEWEEEEEW
WEEEWEEEEEDEEEEEEWEW
WEWEEEEWWEEEWEEEWEEW
WEWEEEEEWWEEEEEEWEEW
WEWWEWEEEEWEEWEEEEEW
WWWWWWWWWWWWWWWWWWWW

WWWWWWWWWWWWWWWWWWWW
WWWWEWWEWEEEYYWEEEEW
WWEEEWEEEEEWWEWEEEEW
WWEEYWWEEEEEEEEEEYYW
WEEEWEEEEEEEEWEEWEEW
WEEEEEEWEEYWEEEEEEEW
WEWEEEGWEEEEEEYEEEEW
WYEEEEEEWEEEEEEEEEEW
WEEEEEEEWEEWEEEWEEEW
WEEEEEEEEEEEEEEEWWEW
WEEEEWEWEEEEEWEEEWEW
WEWEEEEWWEEEEEEEWEYW
WYEEEEWWWEEEEEEEWEEW
WEEEEWEWEWEEEEEEEEEW
WEEEEEEEEEWEEWEEEEEW
WEEEWEEEEEYEEEEEEWEW
WEWEEEEWWEEEWEEEWEEW
WEWEEEEEWWEEEEEEWEEW
WEWWEWEEEEWEEWEEEEEW
WWWWWWWWWWWWWWWWWWWW