WWWWWWWWWWWWWWWWWW
WWWWWWWWEEEEWWWWWW
WWWWWWEEEEEEWWWWWW
WWWWWWWWWWEEWEEWWW
WWWWWWWWWWEEEEWWWW
WWWWEEEWWEEEWWWWWW
WWWWEWEWEEEEWWWWWW
WWWWEWEEEEEEEWWWWW
WWWWEEEEEEEEEWWWWW
WWEEEEEEEEEWWWWWWW
WGEEEEEEEEWWWWWWWW
WEEEEEWEEEEEWWWWWW
WWWEEWWWWEEEEWWWWW
WEEEEEEEWEEWWWWWWW
WWEEEEEEWEEWWWWWWW
WWEEEEEEEEWWWWWWWW
WWEEEEEWEEWWWWWWWW
WWWWWWWWWWWWWWWWWW

WWWWWWWWWWWWWWWWWW
WWWWWWWWEEEEWWWWWW
WWWWWWEEEEEEWWWWWW
WWWWWWWWWWEEWEEWWW
WWWWWWWWWWEEEEWWWW
WWWWEEEWWEEEWWWWWW
WWWWEWEWEEEEWWWWWW
WWWWEWEEEEEEEWWWWW
WWWWEEEEEEEEEWWWWW
WWEEEEEEEEEWWWWWWW
WGEEEEEEEEWWWWWWWW
WEEEEEWEEEEEWWWWWW
WWWEEWWWWEEEEWWWWW
WEEEEEEEWEEWWWWWWW
WWEEEEEEWEEWWWWWWW
WWEEEEEEEEWWWWWWWW
WWEEEEEWEEWWWWWWWW
WWWWWWWWWWWWWWWWWW