WWWWWWWWWWWWWWW
WEEEEEWWEWEEEEW
WWWEEEEWEWEEEEW
WEWEEWEEEEWEWEW
WEEEEWWEEWWEEEW
WEEWEEEEEEEWEWW
WEEEEEEWWEEEEWW
WWEEEEEEWEWEEWW
WEWEEEEEWEEEEEW
WEEEEEEWWWWEEEW
WEEEEWWWEWWEEEW
WEWEEEWEEWWEWWW
WGEEEWEEWEEEEWW
WEEEEEEEWEWEEEW
WWWWWWWWWWWWWWW

WWWWWWWWWWWWWWW
WEEEEEWWEWEEEEW
WWWEEEEWEWEEEEW
WEWEEWEEEEWEWEW
WEEEEWWEEWWEEEW
WEEWEEEEEEEWEWW
WEEEEEEWWEEEEWW
WWEEEEEEWEWEEWW
WEWEEEEEWEEEEEW
WEEEEEEWWWWEEEW
WEEEEWWWEWWEEEW
WEWEEEWEEWWEWWW
WGEEEWEEWEEEEWW
WEEEEEEEWEWEEEW
WWWWWWWWWWWWWWW