WWWWWWWWWW
WWEWEEEEWW
WEEEEGEEEW
WWEEWEEEWW
WEEEEEEEEW
WEEEEEEEWW
WEEEWEEEEW
WEEEEEEWEW
WWWWWEEEEW
WWWWWWWWWW

WWWWWWWWWW
WWEWEEEEWW
WEEEEGEEEW
WWEEWEEEWW
WEEEEEEEEW
WEEEEEEEWW
WEEEWEEEEW
WEEEEEEWEW
WWWWWEEEEW
WWWWWWWWWW