WWWWWWWWWWWW
WEEEEEEEWEKW
WEWEDWEEWWSW
WWEEEEEKEGEW
WEEEEWWEEWWW
WEWWWWWEEWEW
WEEEEWWEEEEW
WWWEEWEEEWEW
WEEEWWEEWWEW
WKEWWEEWEEEW
WEEDWEEWEWWW
WWWWWWWWWWWW

WWWWWWWWWWWW
WEEEEEEEWEYW
WEWEYWEEWWEW
WWEEEEEYEGEW
WEEEEWWEEWWW
WEWWWWWEEWEW
WEEEEWWEEEEW
WWWEEWEEEWEW
WEEEWWEEWWEW
WYEWWEEWEEEW
WEEYWEEWEWWW
WWWWWWWWWWWW