WWWWWWWWWW
WEEEEEEWEW
WEEEEEEEEW
WEEWEWEWEW
WEEEEEWEWW
WEEEEEWEEW
WEWEWEEEEW
WEEWWEEEEW
WEEEEEEGWW
WWWWWWWWWW

WWWWWWWWWW
WEEEEEEWEW
WEEEEEEEEW
WEEWEWEWEW
WEEEEEWEWW
WEEEEEWEEW
WEWEWEEEEW
WEEWWEEEEW
WEEEEEEGWW
WWWWWWWWWW