WWWWWWWWWWWWWWWWWW
WWWWWWWWWWWWWWWWWW
WWWWWWWWWWWWWWWWWW
WWWWWWWWWWWWWWWWWW
WWWWWWWWWWWWWWWWWW
WWWWWWWWWWWWWWWWWW
WWWWWWWWWWWWWWWWWW
WWWWWKWWWWWWWWWWWW
WWWWWEEWWWWWWWWWWW
WWWWWWEWEEWWWWWWWW
WWWWWWEEEEWEEWWWWW
WWWWWWEEEEDEEWWWWW
WWWWWWEEEEKEEWWWWW
WWWWWWEKEEEEEWWWWW
WWWWEEKEEEEEEEEEWW
WWWWKDEDWEEEEEDEDW
WWWWEESKEKEEEEEGEW
WWWWWWWWWWWWWWWWWW

WWWWWWWWWWWWWWWWWW
WWWWWWWWWWWWWWWWWW
WWWWWWWWWWWWWWWWWW
WWWWWWWWWWWWWWWWWW
WWWWWWWWWWWWWWWWWW
WWWWWWWWWWWWWWWWWW
WWWWWWWWWWWWWWWWWW
WWWWWYWWWWWWWWWWWW
WWWWWEEWWWWWWWWWWW
WWWWWWEWEEWWWWWWWW
WWWWWWEEEEWEEWWWWW
WWWWWWEEEEYEEWWWWW
WWWWWWEEEEYEEWWWWW
WWWWWWEYEEEEEWWWWW
WWWWEEYEEEEEEEEEWW
WWWWYYEYWEEEEEYEYW
WWWWEEEYEYEEEEEGEW
WWWWWWWWWWWWWWWWWW