WWWWWWWWWWWWWWW
WWWEEEWWEKWEEEW
WWEEWSKEEEWEEEW
WEEWWEWWEEDEEKW
WEWEWEEEEEWEEKW
WEWEEEWEEEWWEEW
WWWEWWWWWEEWDWW
WEKGEEWWEEWWEWW
WEEEWWWWWEEWEEW
WEWDEEEEWWDEWEW
WEWEWEEEEEKWWEW
WEWEWEWWEEEEEWW
WEWEEEWEEEEDEWW
WEEEEWEEWEEWEEW
WWWWWWWWWWWWWWW

WWWWWWWWWWWWWWW
WWWEEEWWEYWEEEW
WWEEWEYEEEWEEEW
WEEWWEWWEEYEEYW
WEWEWEEEEEWEEYW
WEWEEEWEEEWWEEW
WWWEWWWWWEEWYWW
WEYGEEWWEEWWEWW
WEEEWWWWWEEWEEW
WEWYEEEEWWYEWEW
WEWEWEEEEEYWWEW
WEWEWEWWEEEEEWW
WEWEEEWEEEEYEWW
WEEEEWEEWEEWEEW
WWWWWWWWWWWWWWW