WWWWWWWWWWWWWWW
WEEEEEEWESWWEWW
WWEWEWEEWKDWEEW
WWEEEEEDEEEWEEW
WWEWWEEEEEEWEEW
WEEWEEWEEEWWEWW
WEEEWEEEEEWEEEW
WEEWEEWEEEEKEWW
WEEWEEEEWWEWEEW
WEEEKWEEEWEEEEW
WDEEEWEEEEEWWEW
WEEDWWWEEEEKEWW
WEEEEWEWEEGEWEW
WEWEEWEEEEEEEEW
WWWWWWWWWWWWWWW

WWWWWWWWWWWWWWW
WEEEEEEWEEWWEWW
WWEWEWEEWYYWEEW
WWEEEEEYEEEWEEW
WWEWWEEEEEEWEEW
WEEWEEWEEEWWEWW
WEEEWEEEEEWEEEW
WEEWEEWEEEEYEWW
WEEWEEEEWWEWEEW
WEEEYWEEEWEEEEW
WYEEEWEEEEEWWEW
WEEYWWWEEEEYEWW
WEEEEWEWEEGEWEW
WEWEEWEEEEEEEEW
WWWWWWWWWWWWWWW