WWWWWWWWWWWWWWWWWWWW
WWKEEEEEEEEEEEEWEEEW
WWEWKEEWEWEWWEEWEEWW
WEEEEEEEEWEWEWWEDWWW
WEEWEWEEEEEWEWEEEDEW
WWEEWWEEWEEWEWEWEEWW
WEEWEWWWEEWEEEEEEEEW
WEEWEEEDWEWKEWEEEWWW
WWWEWWEEWEKWEEWWWWDW
WWEEEWWEEEWWEWEWEEEW
WWWEEWEEEEEEEWEEEEWW
WEEEEEWWEEWEEKEEEEKW
WKWEWEEEWWEEEEESEEEW
WEWWWEWEEEEEEWWKEWEW
WEWEWEEWEWWEEDWEWGEW
WEEDEWWWWKEEKEEEEWEW
WWWEWEEEWEEWEKWWWEEW
WDEEEEEEEWEEEDEWEEEW
WEWDEEEWWWWEEEEEWEWW
WWWWWWWWWWWWWWWWWWWW

WWWWWWWWWWWWWWWWWWWW
WWYEEEEEEEEEEEEWEEEW
WWEWYEEWEWEWWEEWEEWW
WEEEEEEEEWEWEWWEYWWW
WEEWEWEEEEEWEWEEEYEW
WWEEWWEEWEEWEWEWEEWW
WEEWEWWWEEWEEEEEEEEW
WEEWEEEYWEWYEWEEEWWW
WWWEWWEEWEYWEEWWWWYW
WWEEEWWEEEWWEWEWEEEW
WWWEEWEEEEEEEWEEEEWW
WEEEEEWWEEWEEYEEEEYW
WYWEWEEEWWEEEEEEEEEW
WEWWWEWEEEEEEWWYEWEW
WEWEWEEWEWWEEYWEWGEW
WEEYEWWWWYEEYEEEEWEW
WWWEWEEEWEEWEYWWWEEW
WYEEEEEEEWEEEYEWEEEW
WEWYEEEWWWWEEEEEWEWW
WWWWWWWWWWWWWWWWWWWW