WWWWWWWWWWWWWWWWWWWWWWWWWWWWWW
WEEEEEEEEEEWEEEEEEEEEEEEEWEEEW
WEWEEWEWWWEEEEWWEEEEEEEEEEEEEW
WEEEEEEWWEEEWEEEEEEWEEEEEEEEEW
WEWEEEEWEEEEEEEEEEEEWEEEWEEEEW
WEEEWEEEWEEEEEWEEEEEEWWEEEEWWW
WEWEEEEEEEEEEEEEWEEEEEEWEEWEEW
WEEEEEEEEWWEEEEEEWEEEEWEEWWEEW
WEEEEEEEWEEEEEEEEEEWEEEEEWEEEW
WWEEEWEEEWEEEEEEEEEEEEWWEEEEEW
WWEEWEEEEWWWWEEEEEEEEEEWEWWEEW
WEEWEEEEEWEEEEEEEEEEEEEEEEWEEW
WEEEEEEEEEEWEEEEWEEEEEEEWEEEWW
WWEWEEEEEEEEEEEEEEEEEEEEEEEEEW
WWEWEEEEWEEEEEEEEEEWWEWEEEEEEW
WEEEEEEEEEEEEEEWEEEEEEWEWEEEWW
WEEEWEEWWEEEEWEEWEEEEEEEWEEEWW
WWEEWEWEEWEEEEEEEWEWEEEEWEEEEW
WEWEWWWEEEEWEEEEWEEEWEEEEWEEEW
WEWEEEEEEEEEEEEEWWEEWWEEEWWEWW
WEEEEEEEWWEEEWEEWEWEWEEEEEEEEW
WEEWEWEWEEWWEEEEWEEEEEEEEEEEWW
WEEEEEEEEEWEEEEWEEEEEEWEEEEWEW
WWEEEEEEEEEWEEEEEEEEWEEEEEEWEW
WEWWEEEWWEEWEEEEEEEEEEWWEEEGEW
WEEEEEWWEWWWEEEEEEWEEEEEWEEEWW
WEWEEEEEEEEWEEEEEEEEWEEEWWEWWW
WEEEEEEEEEEEEWEEEEEWEEEEWWEEEW
WEEEEEWEEEEEEEEEEEEEEEWWWEEEEW
WWWWWWWWWWWWWWWWWWWWWWWWWWWWWW

WWWWWWWWWWWWWWWWWWWWWWWWWWWWWW
WEEEEEEEEEEWEEEEEEEEEEEEEWEEEW
WEWEEWEWWWEEEEWWEEEEEEEEEEEEEW
WEEEEEEWWEEEWEEEEEEWEEEEEEEEEW
WEWEEEEWEEEEEEEEEEEEWEEEWEEEEW
WEEEWEEEWEEEEEWEEEEEEWWEEEEWWW
WEWEEEEEEEEEEEEEWEEEEEEWEEWEEW
WEEEEEEEEWWEEEEEEWEEEEWEEWWEEW
WEEEEEEEWEEEEEEEEEEWEEEEEWEEEW
WWEEEWEEEWEEEEEEEEEEEEWWEEEEEW
WWEEWEEEEWWWWEEEEEEEEEEWEWWEEW
WEEWEEEEEWEEEEEEEEEEEEEEEEWEEW
WEEEEEEEEEEWEEEEWEEEEEEEWEEEWW
WWEWEEEEEEEEEEEEEEEEEEEEEEEEEW
WWEWEEEEWEEEEEEEEEEWWEWEEEEEEW
WEEEEEEEEEEEEEEWEEEEEEWEWEEEWW
WEEEWEEWWEEEEWEEWEEEEEEEWEEEWW
WWEEWEWEEWEEEEEEEWEWEEEEWEEEEW
WEWEWWWEEEEWEEEEWEEEWEEEEWEEEW
WEWEEEEEEEEEEEEEWWEEWWEEEWWEWW
WEEEEEEEWWEEEWEEWEWEWEEEEEEEEW
WEEWEWEWEEWWEEEEWEEEEEEEEEEEWW
WEEEEEEEEEWEEEEWEEEEEEWEEEEWEW
WWEEEEEEEEEWEEEEEEEEWEEEEEEWEW
WEWWEEEWWEEWEEEEEEEEEEWWEEEGEW
WEEEEEWWEWWWEEEEEEWEEEEEWEEEWW
WEWEEEEEEEEWEEEEEEEEWEEEWWEWWW
WEEEEEEEEEEEEWEEEEEWEEEEWWEEEW
WEEEEEWEEEEEEEEEEEEEEEWWWEEEEW
WWWWWWWWWWWWWWWWWWWWWWWWWWWWWW