WWWWWWWWWWWW
WEEEEEEWEEEW
WEEEWEEWEEEW
WEEEEEEGEEWW
WEEEEEWEEEEW
WEEEWEEWWEEW
WEWEWWKEWEEW
WEEEEEWEDEWW
WEEEWEEEEEWW
WEEWWEESEEWW
WEEEEEEKEEEW
WWWWWWWWWWWW

WWWWWWWWWWWW
WEEEEEEWEEEW
WEEEWEEWEEEW
WEEEEEEGEEWW
WEEEEEWEEEEW
WEEEWEEWWEEW
WEWEWWYEWEEW
WEEEEEWEYEWW
WEEEWEEEEEWW
WEEWWEEEEEWW
WEEEEEEYEEEW
WWWWWWWWWWWW