WWWWWWWWWWWW
WSWEEEWEWEEW
WKEEWEEEEEEW
WEEEEEEEEEEW
WGEEEWWEEEEW
WEEEWWEEWEEW
WEEEWEEEEEEW
WWEEEEEEEEEW
WDEWEEWEEEWW
WEEEWEEEEEEW
WEEEEEEEEEEW
WWWWWWWWWWWW

WWWWWWWWWWWW
WEWEEEWEWEEW
WYEEWEEEEEEW
WEEEEEEEEEEW
WGEEEWWEEEEW
WEEEWWEEWEEW
WEEEWEEEEEEW
WWEEEEEEEEEW
WYEWEEWEEEWW
WEEEWEEEEEEW
WEEEEEEEEEEW
WWWWWWWWWWWW