WWWWWWWWWW
WEWWWEWWWW
WEEEEEEWWW
WEGWWEEEWW
WEEEEEEEEW
WWEWWEWWWW
WWWEEEEWWW
WEEEWWEWEW
WWWEEWEEEW
WWWWWWWWWW

WWWWWWWWWW
WEWWWEWWWW
WEEEEEEWWW
WEGWWEEEWW
WEEEEEEEEW
WWEWWEWWWW
WWWEEEEWWW
WEEEWWEWEW
WWWEEWEEEW
WWWWWWWWWW