WWWWWWWWWW
WEEWWEEEWW
WEEEEEEEEW
WWEWWEEEWW
WWEEWWWEWW
WEEEEEEEEW
WEWWEWEWWW
WEEEWEEEWW
WEEEGWEEWW
WWWWWWWWWW

WWWWWWWWWW
WEEWWEEEWW
WEEEEEEEEW
WWEWWEEEWW
WWEEWWWEWW
WEEEEEEEEW
WEWWEWEWWW
WEEEWEEEWW
WEEEGWEEWW
WWWWWWWWWW