WWWWWWWWWW
WEWEEEWWWW
WEEEWEEEWW
WEWEEEWWWW
WEWEWEEWEW
WGWEWEEWEW
WEEEEEEEEW
WEEEEEWWEW
WWEWWEWWEW
WWWWWWWWWW

WWWWWWWWWW
WEWEEEWWWW
WEEEWEEEWW
WEWEEEWWWW
WEWEWEEWEW
WGWEWEEWEW
WEEEEEEEEW
WEEEEEWWEW
WWEWWEWWEW
WWWWWWWWWW