WWWWWWWWWWWWWWWWWWWWWWWWWWWWWW
WEEEEEEEEEEEEEWEEEEEEEEEEEEEEW
WEEEEEEEEEEEEWEWEEEEEEEEEEEEEW
WEEEEEEWEEEEEEEWEEEWEWEEEEEWEW
WEEEWEEEWEEEEEEEEWEEEWEEEEEEEW
WEEEEEEEEEEWEEEEEEEWEEEEEEEEEW
WEEEEEEWEEEEEEWEWEEEEEEEEEEWEW
WEEEWEEEEEEEEEEEEEEEEWEEEEEEEW
WEEEEEEEEEEEWEWEEEWWEEEEWWEEWW
WEEEEEWEWEEEEEEEEEEWEEEWEWEEEW
WEEWEEEEEEEEWEEEWEEEEWEEEEEEEW
WEEEWEEEEEEEWEEEEEEEWEEEEEEEEW
WEEEEEEEWEEEEEEEEEEEEEEEEEEWEW
WWEEEEEEEWEWWEEEEEEWEEEEEEEEEW
WEEEEEEEEWWEEEEEEWEEEEEEEEEEEW
WEWEEEEEEWEEEEEEEEEEEEEEEEEEEW
WEEEEEEEEEEEEEEEEEEEEWEEEEWEEW
WEEEEEEEEEEEEEEEEEEEEEEWEEEEWW
WEEEEEEEEEEEEEEEEEEEWWEEEEEEWW
WEEWEEEEEWEEEEEEEWEEEEEEEEEEEW
WEEEEWEEEEEEEEEWEEEEEEEEEEEEEW
WEEWEEEEEEEEWEWEEEEEEEEEEEEEEW
WEWEEEWEEEEEEEEEEEEEEEEEEEEEEW
WEWEEEEEEEWEEEEEEEWEEGEEEEEEEW
WEEEEEEEWEEEEEEWEEEEEEWEEEEEEW
WEEWEEEWEEWEEEEEWEWEEEEEEEWEEW
WEEEEEEEEEEEEEEEEEEEEEEEEEWEEW
WWEEWEEEEEEEEWEEEEEEEEEEEEEEEW
WEEEWEEEWEEEEEEEEEEEEEEEEEEEWW
WWWWWWWWWWWWWWWWWWWWWWWWWWWWWW

WWWWWWWWWWWWWWWWWWWWWWWWWWWWWW
WEEEEEEEEEEEEEWEEEEEEEEEEEEEEW
WEEEEEEEEEEEEWEWEEEEEEEEEEEEEW
WEEEEEEWEEEEEEEWEEEWEWEEEEEWEW
WEEEWEEEWEEEEEEEEWEEEWEEEEEEEW
WEEEEEEEEEEWEEEEEEEWEEEEEEEEEW
WEEEEEEWEEEEEEWEWEEEEEEEEEEWEW
WEEEWEEEEEEEEEEEEEEEEWEEEEEEEW
WEEEEEEEEEEEWEWEEEWWEEEEWWEEWW
WEEEEEWEWEEEEEEEEEEWEEEWEWEEEW
WEEWEEEEEEEEWEEEWEEEEWEEEEEEEW
WEEEWEEEEEEEWEEEEEEEWEEEEEEEEW
WEEEEEEEWEEEEEEEEEEEEEEEEEEWEW
WWEEEEEEEWEWWEEEEEEWEEEEEEEEEW
WEEEEEEEEWWEEEEEEWEEEEEEEEEEEW
WEWEEEEEEWEEEEEEEEEEEEEEEEEEEW
WEEEEEEEEEEEEEEEEEEEEWEEEEWEEW
WEEEEEEEEEEEEEEEEEEEEEEWEEEEWW
WEEEEEEEEEEEEEEEEEEEWWEEEEEEWW
WEEWEEEEEWEEEEEEEWEEEEEEEEEEEW
WEEEEWEEEEEEEEEWEEEEEEEEEEEEEW
WEEWEEEEEEEEWEWEEEEEEEEEEEEEEW
WEWEEEWEEEEEEEEEEEEEEEEEEEEEEW
WEWEEEEEEEWEEEEEEEWEEGEEEEEEEW
WEEEEEEEWEEEEEEWEEEEEEWEEEEEEW
WEEWEEEWEEWEEEEEWEWEEEEEEEWEEW
WEEEEEEEEEEEEEEEEEEEEEEEEEWEEW
WWEEWEEEEEEEEWEEEEEEEEEEEEEEEW
WEEEWEEEWEEEEEEEEEEEEEEEEEEEWW
WWWWWWWWWWWWWWWWWWWWWWWWWWWWWW