WWWWWWWWWWWWWWWWWWWW
WEEEWWWEEEEWEEEEEEEW
WWEESEWEEWEDEEDEWWEW
WEEEKWEEEEEEWEEKKEEW
WWEEEEEEEEEEEWEEWWEW
WEEWEEEWWEWEWWWEWEWW
WWKEEWEEEEEEEWEEEEEW
WEWEEEEEWEWWWEWEWEEW
WEDEWWEEWWWEWEEDEKEW
WEWEEEEEEEEEEWEEWEEW
WEWDEEDWEWEEEEEWWWKW
WWEEWWEEEEEWWWDEEDEW
WDEEEEEWEEWEEEEEEEEW
WEWWEEEWEEWEEWEWEWEW
WEWWEWEWDWWEEEEWEEEW
WEEEWWEEWKEWWEWGWWWW
WEEEEEEEDEWWWEWEEEEW
WEEWWEEEWWEWDEWEEEEW
WEWEEEEEEEEEWEEEWEWW
WWWWWWWWWWWWWWWWWWWW

WWWWWWWWWWWWWWWWWWWW
WEEEWWWEEEEWEEEEEEEW
WWEEEEWEEWEYEEYEWWEW
WEEEYWEEEEEEWEEYYEEW
WWEEEEEEEEEEEWEEWWEW
WEEWEEEWWEWEWWWEWEWW
WWYEEWEEEEEEEWEEEEEW
WEWEEEEEWEWWWEWEWEEW
WEYEWWEEWWWEWEEYEYEW
WEWEEEEEEEEEEWEEWEEW
WEWYEEYWEWEEEEEWWWYW
WWEEWWEEEEEWWWYEEYEW
WYEEEEEWEEWEEEEEEEEW
WEWWEEEWEEWEEWEWEWEW
WEWWEWEWYWWEEEEWEEEW
WEEEWWEEWYEWWEWGWWWW
WEEEEEEEYEWWWEWEEEEW
WEEWWEEEWWEWYEWEEEEW
WEWEEEEEEEEEWEEEWEWW
WWWWWWWWWWWWWWWWWWWW