WWWWWWWWWWWW
WWEEEEEEEEWW
WWGWEWDWWEWW
WWEEEWEEEEEW
WEEWEWEWEEWW
WKWEWEWKSWWW
WEEEEEEKWEEW
WWWWEEWWEEEW
WEEEDEEEEWDW
WEEWWWEWWWEW
WWEEWWWWWEEW
WWWWWWWWWWWW

WWWWWWWWWWWW
WWEEEEEEEEWW
WWGWEWYWWEWW
WWEEEWEEEEEW
WEEWEWEWEEWW
WYWEWEWYEWWW
WEEEEEEYWEEW
WWWWEEWWEEEW
WEEEYEEEEWYW
WEEWWWEWWWEW
WWEEWWWWWEEW
WWWWWWWWWWWW