WWWWWWWWWWWWWWWWWWWW
WEEEEWWEEEEEEWEWWEEW
WWEWEEEEEEEWWWEEEEEW
WEEWEWEEWEWWEWEEWEEW
WWEEWWWEEWEEEEEEWEEW
WEEEEEEEEEWEWEEWEWEW
WWEWEEEWEEWEWWEWEEEW
WEWEEWEEEEEEWEEEEEEW
WEEEEEEEEEWEEEEEWWEW
WEEEEWWWEEWWEEEEWEEW
WEEEWEEWEEWWEWEEEEWW
WEEWEEEEEWEEEWEEWEEW
WWWEEWWEEWWWWEWEWEEW
WEWEEEEEWWEEEEWEEWEW
WEEEEEEWWEEEWEWWWEEW
WEWEWEEEEEEEEEWWEEEW
WEGEEEWEEEWEWEEEWEWW
WEEEEEEWWEEWWEEEEEWW
WWEEEEEEWEEEEEEWWEWW
WWWWWWWWWWWWWWWWWWWW

WWWWWWWWWWWWWWWWWWWW
WEEEEWWEEEEEEWEWWEEW
WWEWEEEEEEEWWWEEEEEW
WEEWEWEEWEWWEWEEWEEW
WWEEWWWEEWEEEEEEWEEW
WEEEEEEEEEWEWEEWEWEW
WWEWEEEWEEWEWWEWEEEW
WEWEEWEEEEEEWEEEEEEW
WEEEEEEEEEWEEEEEWWEW
WEEEEWWWEEWWEEEEWEEW
WEEEWEEWEEWWEWEEEEWW
WEEWEEEEEWEEEWEEWEEW
WWWEEWWEEWWWWEWEWEEW
WEWEEEEEWWEEEEWEEWEW
WEEEEEEWWEEEWEWWWEEW
WEWEWEEEEEEEEEWWEEEW
WEGEEEWEEEWEWEEEWEWW
WEEEEEEWWEEWWEEEEEWW
WWEEEEEEWEEEEEEWWEWW
WWWWWWWWWWWWWWWWWWWW