WWWWWWWWWWWWWWWWWWWWWWWWWWWWWW
WEEEWEWEEWEEEEEEEWEEEEEEWEEWEW
WWEEEEEEEEEWEWEEEEEWWEEEEWEEEW
WEWEEEWEEEEEWEEEEEEEEEEEEWEEWW
WEEEEWEEEEEEWEEEEWWEEEWEWEEEEW
WEWEEEEEEEWEWEEEEEEWWWEWEEEEEW
WWEEWWEWEEWEEEEEEEWEEEEEWEWEWW
WEEEEWEEEEEEEEEEWEEEEEEEEEEEEW
WEEEEEEEEEEEEEEWEEEEEEEEWEWEEW
WEEWEEWEWEWEEWWWEEWWEEWEEWEEEW
WEEEEEEEWWEWEEEEWEEWEEEEEEEEEW
WEEEEEEEEEEEEEEEEEEEEEEWEEEEEW
WWWEEEEWEEEEEEWEEEEEEWWWEEEEEW
WEEEEEEEEEEEEEEEWEEEWEEEWEEEEW
WWEEEEEEEEEEEEEWEEEWWEEWWEWEGW
WEEEEWWEEEEEEWEEEEEEEWEEEEEEWW
WEWEEEEWEEWWEWEEWWEEEEEWEEEEEW
WEEEEEEEEEEEWWWEEEEEEWEEEEEEWW
WWEEEWEWEEEEEEWEEEEEEEEEEEWEEW
WEWEEEEEEEEEEEWEWEEEEWEEWEEWEW
WEEWEEEEWEWEEWEWEEEEWEWEWWEEEW
WWEEEEWWEEEEEEEWEEEEEEEEWEWWEW
WWEEEWEEEEEEEWEEEWWEEEEEEEEEEW
WEEWEEEWEEWEEWEEWEEEEEEEEEEEWW
WEWEEEEWWEEEEEEEEEWEEWEEEEEEEW
WEEEEEWEWEEEEEEEEEEEEEWWEEEEEW
WEEWEEEEEEEEEEWWEWWEEEWWEWEEEW
WEEWEWEEEEEWEEEEEEEEEEEWEEEWWW
WEWEEWWWEEEEEEEWEEEEEEWEEWEEEW
WWWWWWWWWWWWWWWWWWWWWWWWWWWWWW

WWWWWWWWWWWWWWWWWWWWWWWWWWWWWW
WEEEWEWEEWEEEEEEEWEEEEEEWEEWEW
WWEEEEEEEEEWEWEEEEEWWEEEEWEEEW
WEWEEEWEEEEEWEEEEEEEEEEEEWEEWW
WEEEEWEEEEEEWEEEEWWEEEWEWEEEEW
WEWEEEEEEEWEWEEEEEEWWWEWEEEEEW
WWEEWWEWEEWEEEEEEEWEEEEEWEWEWW
WEEEEWEEEEEEEEEEWEEEEEEEEEEEEW
WEEEEEEEEEEEEEEWEEEEEEEEWEWEEW
WEEWEEWEWEWEEWWWEEWWEEWEEWEEEW
WEEEEEEEWWEWEEEEWEEWEEEEEEEEEW
WEEEEEEEEEEEEEEEEEEEEEEWEEEEEW
WWWEEEEWEEEEEEWEEEEEEWWWEEEEEW
WEEEEEEEEEEEEEEEWEEEWEEEWEEEEW
WWEEEEEEEEEEEEEWEEEWWEEWWEWEGW
WEEEEWWEEEEEEWEEEEEEEWEEEEEEWW
WEWEEEEWEEWWEWEEWWEEEEEWEEEEEW
WEEEEEEEEEEEWWWEEEEEEWEEEEEEWW
WWEEEWEWEEEEEEWEEEEEEEEEEEWEEW
WEWEEEEEEEEEEEWEWEEEEWEEWEEWEW
WEEWEEEEWEWEEWEWEEEEWEWEWWEEEW
WWEEEEWWEEEEEEEWEEEEEEEEWEWWEW
WWEEEWEEEEEEEWEEEWWEEEEEEEEEEW
WEEWEEEWEEWEEWEEWEEEEEEEEEEEWW
WEWEEEEWWEEEEEEEEEWEEWEEEEEEEW
WEEEEEWEWEEEEEEEEEEEEEWWEEEEEW
WEEWEEEEEEEEEEWWEWWEEEWWEWEEEW
WEEWEWEEEEEWEEEEEEEEEEEWEEEWWW
WEWEEWWWEEEEEEEWEEEEEEWEEWEEEW
WWWWWWWWWWWWWWWWWWWWWWWWWWWWWW