WWWWWWWWWWWWWWWWWW
WEWWWEEEEWWEWEWEEW
WEEEEWGWEEWEEEEWEW
WEEWEEEEEWWEEWWEEW
WWEWEWWEEWEWEWWEWW
WEEEEEEWEEEEEWWEWW
WEEEEEEEWEEWEEWEWW
WWWWEWWWWEWWEEEEEW
WEEEEWEEEEWEWWWWEW
WEWEEEEEWWWEEEEEEW
WEWEEWEEEEWEWEEEEW
WWEEEWEEEEEWWEEEWW
WEEWWWEWWEEEEEEEWW
WEEEWWEEWWWEWEEEEW
WWWWEWEEEEEEWEEWEW
WWWEEEEEEEEEEWEWEW
WWWEEWEEEWWEWWWEEW
WWWWWWWWWWWWWWWWWW

WWWWWWWWWWWWWWWWWW
WEWWWEEEEWWEWEWEEW
WEEEEWGWEEWEEEEWEW
WEEWEEEEEWWEEWWEEW
WWEWEWWEEWEWEWWEWW
WEEEEEEWEEEEEWWEWW
WEEEEEEEWEEWEEWEWW
WWWWEWWWWEWWEEEEEW
WEEEEWEEEEWEWWWWEW
WEWEEEEEWWWEEEEEEW
WEWEEWEEEEWEWEEEEW
WWEEEWEEEEEWWEEEWW
WEEWWWEWWEEEEEEEWW
WEEEWWEEWWWEWEEEEW
WWWWEWEEEEEEWEEWEW
WWWEEEEEEEEEEWEWEW
WWWEEWEEEWWEWWWEEW
WWWWWWWWWWWWWWWWWW